a	a
a	ɐ
à	a
á	a
â	ɐ
â	ɐ̃
ã	ɐ̃
aba	aβɐ
abacate	ɐβɐkatɨ
abacateiro	ɐbakɐtɐjɾu
abacaxi	ɐbɐkɐʃi
abacaxizeiro	ɐbɐkɐʃizɐjɾu
abacharelado	ɐbɐʃɐɾɘladu
abacial	ɐbɐsial
abacista	ɐbasiʃtɐ
ábaco	abɐku
abactor	ɐbɐktoɾ
abade	ɐbadɨ
abadesa	abadeza
abadessa	abɐdesɐ
abadia	ɐbɐdiɐ
abafação	ɐbɐfɐsɐ̃w̃
abafada	ɐbɐfadɐ
abafadamente	ɐbɐfadɐmẽtɨ
abafadiço	ɐbɐfɐdisu
abafado	ɐbɐfadu
abafador	ɐbɐfɐdoɾ
abafar	ɐbɐfaɾ
abaixamento	ɐbajʃɐmẽtu
abaixar	ɐbɐjʃaɾ
abaixo	ɐbajʃu
abajur	abɐʒuɾ
abalado	ɐbɐladu
abalar	ɐbɐlaɾ
abalava	ɐbɐlavɐ
abalizado	ɐbɐlizadu
abalou	ɐbɐlow
abanar	ɐbɐnaɾ
abandonada	ɐβɐ̃dunaðɐ
abandonado	ɐβɐ̃dunaðu
abandonar	ɐbɐ̃dunaɾ
abandonara	ɐβɐ̃dunaɾɐ
abandonará	ɐβɐ̃dunɐɾa
abandono	ɐβɐ̃donu
abandono	ɐβɐ̃dɔnu
abas	aβɐʃ
abastado	ɐβɐʃtaðu
abastar	ɐβɐʃtaɾ
abastecer	ɐβɐʃtɨseɾ
abater	ɐbɐteɾ
abatimento	ɐβɐtimẽtu
abaxial	ɐβɐksjal
abdicar	ɐβðikaɾ
abdicar	ɐbdikaɾ
abdómen	ɐbdɔmɛn
abdominal	aβðomɪnaɫ
abduzir	aβðuziɾ
abel	abɛɫ
abelha	ɐβeʎɐ
abelha	ɐβɐʎɐ
abelha	ɐβɐjʎɐ
abençoado	ɐβẽswaðu
abençoar	ɐβẽswaɾ
aberta	ɐβɛɾtɐ
abertas	ɐβɛɾtɐʃ
aberto	ɐbɛɾtu
abertos	ɐβɛɾtuʃ
abertura	ɐβɨɾtuɾɐ
abeto	ɐβɛtu
abismar	ɐβiʒmaɾ
abismo	ɐβiʒmu
abjeção	ɐbʒɛsɐ̃w̃
abjeto	ɐbʒɛtu
abóbada	ɐβɔβɐðɐ
abobadar	ɐβuβɐðaɾ
abobado	abobadu
abóbeda	ɐβɔβɨðɐ
abóbora	ɐβɔβuɾɐ
abolição	ɐβulisɐ̃w̃
abominação	ɐβuminɐsɐ̃w̃
abominar	ɐβuminaɾ
abomináveis	ɐβuminavɛʃ
abominável	ɐβuminavɛɫ
abondança	ɐβõdɐ̃sɐ
aborígene	ɐβuɾiʒɨnɨ
abotoar	ɐbutwaɾ
abraçar	ɐbɾɐsaɾ
abraço	ɐβɾasu
abrandamento	ɐβɾɐ̃dɐmẽtu
abrangência	abɾɐ̃ʒẽsja
abranger	ɐβɾɐ̃ʒeɾ
abrantes	ɐβɾɐ̃tɨʃ
abria	ɐβɾiɐ
abricó	abɾikɔ
abrigado	ɐβɾiɣaðu
abrigar	ɐbɾiɡaɾ
abrigo	ɐβɾiɣu
abril	ɐbɾil
abrindo	ɐβɾĩdu
abrir	ɐβɾiɾ
abriu	ɐβɾiw
abrupto	ɐβɾuptu
absolutamente	ɐbsulutɐmẽtɨ
absoluto	ɐbsulutu
absonância	absonɐ̃sja
abstenção	ɐbʃtẽsɐ̃w̃
abstrair	ɐβʃtɾɐiɾ
absurdo	ɐbsuɾðu
abundância	ɐbũdɐ̃sjɐ
abundante	ɐbũdɐ̃tɨ
abundar	ɐbũdaɾ
abusar	ɐβuzaɾ
abusar	ɐbuzaɾ
abutre	ɐβutɾɨ
acaba	ɐkaβɐ
acabado	ɐkɐβaðu
acabando	ɐkɐβɐ̃du
acabava	ɐkɐβavɐ
acabou	ɐkɐβow
açacalar	ɐsɐkɐlaɾ
academia	ɐkɐðɨmiɐ
académico	ɐkɐdɛmiku
açafrão	ɐsɐfɾɐ̃w̃
acaju	akaʒu
acalmar	ɐkaɫmaɾ
acamado	ɐkɐmaðu
acampamento	ɐkɐ̃pɐmẽtu
acampar	ɐkɐ̃paɾ
acanhado	ɐkɐɲadu
ação	asɐ̃w̃
acarretar	ɐkɐʁɨtaɾ
acartar	ɐkɐɾtaɾ
acaso	ɐkazu
aceder	ɐsɨðeɾ
aceitação	əsetəsə̃ʊ
aceitações	əsetəsʊ̃ɪʃ
aceitar	ɐsɐjtaɾ
aceitar	ɐsejtaɾ
acelerador	ɐsɨlɨɾɐðoɾ
acelerar	ɐsɨlɨɾaɾ
acendendo	ɐsẽdẽdu
acender	ɐsẽdeɾ
aceno	ɐsenu
acento	ɐsẽtu
acercar	ɐsɨɾkaɾ
acertar	ɐsɨɾtaɾ
acerto	aseɾtu
acerto	aseʁtu
acerto	asɛɾtu
acerto	asɛʁtu
aceso	ɐsezu
acessar	ɐsɨsaɾ
acesso	ɐsɛsu
acetato	ɐsɨtatu
acha	aʃɐ
achado	ɐʃaðu
achando	ɐʃɐ̃du
achaparrado	aʃapaʁadu
achaparrar	aʃapaʁaɾ
achaque	ɐʃakɨ
achar	ɐʃaɾ
achava	ɐʃavɐ
acho	aʃu
achou	ɐʃow
acidentalmente	əsidɪ̃təlmɛ̃t̪
acidente	ɐsidẽtɨ
ácido	asidu
acima	ɐsimɐ
aclarar	ɐklɐɾaɾ
aço	asu
açoite	ɐsojtɨ
acolhedor	ɐkuʎɨðoɾ
acolher	ɐkuʎeɾ
acolhimento	ɐkuʎimẽtu
acomete	akomɛtʃi
acompanhado	ɐkõpɐɲaðu
acompanhar	ɐkõpɐɲaɾ
aconchego	ɐkõʃeɣu
aconselhada	ɐkõsɨʎaðɐ
aconselhado	ɐkõsɨʎaðu
aconselhar	ɐkõsɨʎaɾ
acontecer	ɐkõtɨseɾ
acontecimento	ɐkõtɨsimẽtu
açor	ɐsoɾ
açorda	ɐsoɾðɐ
acordado	ɐkuɾðaðu
acordar	ɐkuɾdaɾ
acordo	ɐkoɾðu
acordo	ɐkɔɾðu
acostumado	ɐkuʃtumaðu
acostumar	ɐkuʃtumaɾ
açougue	ɐsowɣɨ
acre	akɾɨ
acreditar	ɐkɾɨðitaɾ
acrescentar	ɐkɾɨʃsẽtaɾ
acrescentou	ɐkɾɨʃsẽtow
acrescer	ɐkɾɨʃseɾ
acrograma	akɾoɡɾɐ̃mɐ
actuação	ɐtwɐsɐ̃w̃
açúcar	ɐsukɐɾ
açucena	ɐsusenɐ
açude	ɐsuðɨ
acudir	ɐkuðiɾ
acudiu	ɐkuðiw
açular	ɐsulaɾ
acúmulo	ɐkumulu
acúmulo	akumulu
acurácia	akuɾasja
acusado	ɐkuzaðu
acusar	ɐkuzaɾ
adamastor	ɐðɐmɐʃtoɾ
adão	ɐðɐ̃w̃
adaptação	ɐðɐptɐsɐ̃w̃
adega	ɐðɛɣɐ
adélio	adɛlju
adelo	ɐðɛlu
adentrar	adẽtɾaʁ
aderência	adɨɾɐ̃j̃sjə
adesão	ɐðɨzɐ̃w̃
adiantar	ɐdjɐ̃taɾ
adiante	ɐðjɐ̃tɨ
adiantou	ɐdjɐ̃tow
adicionar	ɐðisjunaɾ
ádito	aðitu
administrador	ɐdminiʃtɾɐdoɾ
admiração	ɐdmiɾɐsɐ̃w̃
admirador	ɐðmiɾɐdoɾ
admirar	ɐdmiɾaɾ
admitir	ɐdmitiɾ
adoçante	aðusɐ̃tɨ
adoção	ɐðɔsɐ̃w̃
adoçar	ɐðusaɾ
adoecer	ɐðwɨseɾ
adoecer	ɐðuɨseɾ
adoração	əduɾəsə̃ʊ
adorar	ɐðuɾaɾ
adorável	ɐðuɾavɛɫ
adormecido	ɐðuɾmɨsiðu
adornar	ɐðuɾnaɾ
adorno	ɐðoɾnu
adorno	ɐðɔɾnu
adrede	ɐðɾeðɨ
adscrito	ɐðɨʃkɾitu
aduela	ɐdwɛlɐ
adufe	ɐðufɨ
adulto	ɐðuɫtu
advérbio	adʒivɛɦbɪʊ
adversário	ɐdvɨɾsaɾju
adverso	ɐdvɛɾsu
aéreo	ɐɛɾju
aeroporto	ɐɛɾɔpoɾtu
afã	ɐfɐ̃
afastado	ɐfɐʃtaðu
afastar	ɐfɐʃtaɾ
afável	ɐfavɛɫ
afeição	ɐfɐjsɐ̃w
afete	afɛtʃi
afeto	ɐfɛtu
afiar	ɐfjaɾ
afinar	ɐfinaɾ
afinidade	ɐfiniðaðɨ
afirmar	ɐfiɾmaɾ
aflição	ɐflisɐ̃w̃
aflita	ɐflitɐ
aflito	ɐflitu
afoito	afojtu
afonso	ɐfõsu
afora	ɐfɔɾɐ
afortunadamente	ɐfuɾtunaðɐmẽtɨ
africano	ɐfɾikɐnu
afrontar	ɐfɾõtaɾ
afta	afta
afta	aftɐ
afta	afitɐ
agá	ɐɣa
agachar	ɐɡaʃaɾ
agadá	ɐɣɐða
agami	ɐɣɐmi
agasalhar	ɐɣɐzɐʎaɾ
agasalho	ɐɣɐzaʎu
agência	ɐʒẽsjɐ
agiota	ɐʒjɔtɐ
agiotagem	ɐʒjutaʒɐ̃j̃
agir	ɐʒiɾ
agitação	ɐʒitɐsɐ̃w̃
agitadamente	ɐʒitaðɐmẽtɨ
agitado	ɐʒitaðu
agitar	ɐʒitaɾ
agoiro	ɐɣojɾu
agoiros	ɐɣojɾuʃ
agora	ɐɡɔɾɐ
agosto	ɐɡoʃtu
agoural	ɐɣowɾaɫ
agourar	ɐɡowɾaɾ
agouro	ɐɡowɾu
agouros	ɐɣowɾuʃ
agradar	ɐɡɾɐdaɾ
agradara	ɐɣɾɐðaɾɐ
agradável	ɐɣɾɐðavɛɫ
agrafador	ɐɡɾɐfɐdoɾ
agrafo	ɐɡɾafu
ágrafo	aɣɾɐfu
agreste	ɐɣɾɛʃtɨ
agrupamento	ɐɣɾupɐmẽtu
agrupar	ɐɣɾupaɾ
água	aɡwɐ
aguadeiro	aɡwɐdɐjɾu
aguante	ɐɣwɐ̃tɨ
aguar	ɐɡwaɾ
aguardente	aɣwaɾðẽtɨ
águas	aɡwəʃ
aguça	ɐɣusɐ
aguçar	ɐɣusaɾ
agudo	ɐɣuðu
águeda	aɡɨdɐ
aguerrido	aɡeʁidu
aguerrido	aɡeridu
águia	aɣjɐ
águia	aɣiɐ
aguião	ɐɣjɐ̃w̃
ah	a
aí	ɐi
ainda	ɐĩdɐ
aio	aju
airoso	ajɾozu
aja	aʒɐ
ajoelhar	ɐʒwɨʎaɾ
ajuda	ɐʒuðɐ
ajudante	ɐʒuðɐ̃tɨ
ajudar	ɐʒuðaɾ
ajuntamento	ɐʒũtɐmẽtu
ajuntar	ɐʒũtaɾ
ajustado	ɐʒuʃtaðu
ajustar	ɐʒuʃtaɾ
ajuste	ɐʒuʃtɨ
al	aɫ
ala	alɐ
alabarda	alɐbaɾdɐ
alabarda	alɐbaɾðɐ
alambique	ɐlɐ̃bikɨ
alameda	ɐlɐmeðɐ
alameda	ɐlɐmɛðɐ
alandroal	ɐlɐ̃dɾuaɫ
alapar	ɐlɐpaɾ
alar	ɐlaɾ
alargar	ɐlɐɾɣaɾ
alarve	ɐlaɾvɨ
albânia	aɫβɐniɐ
albânia	aɫβɐnjɐ
albufeira	ɐɫβufɐjɾɐ
álbum	aɫβũ
alça	aɫsɐ
alcácer	aɫkasɛɾ
alcachofra	aɫkɐʃofɾɐ
alcáçova	aɫkasuvɐ
alcalinidade	ɐɫkɐlinidaðɨ
alcaloide	aɫkɐlɔjdɨ
alcançar	aɫkɐ̃saɾ
alcanço	aɫkɐ̃su
alcanena	ɐɫkɐnenɐ
alçar	aɫsaɾ
alcateia	aɫkɐtɐjɐ
alcateia	aɫkɐtejɐ
alcateia	aɫkɐtɐjɐ
alcateia	aɫkɐtejɐ
alcatifa	aɫkɐtifɐ
alcatrão	aɫkɐtɾɐ̃w
alcobaça	ɐɫkuβasɐ
alcochete	ɐɫkuʃetɨ
álcool	alkwɔl
alcoutim	ɐɫkowtĩ
alcova	aɫkovɐ
alcunha	aɫkuɲɐ
aldeia	aɫdɐjɐ
aldeia	aɫdejɐ
aldraba	aɫdɾaβɐ
alecrim	ɐlɨkɾĩ
alegação	ɐlɨɣɐsɐ̃w̃
alegadamente	ɐlɨɣaðɐmẽtɨ
alegre	ɐlɛɣɾɨ
alegremente	ɐlɛɣɾɨmẽtɨ
alegres	ɐlɛɣɾɨʃ
alegria	ɐlɨɣɾiɐ
aleijado	ɐlɐjʒaðu
aleijamento	ɐlɐjʒɐmẽtu
aleijamento	ɐlejʒɐmẽtu
aleijar	ɐlɐjʒaɾ
aleijar	ɐlejʒaɾ
além	alɐ̃j̃
alemanha	ɐlɨmɐɲɐ
alenquer	ɐlẽkɛɾ
alentejo	ɐlẽtɛʒu
aleppo	ɐlɛpu
alertamente	alɛɾtɐmẽtɨ
aletria	ɐlɨtɾiɐ
alexandra	əɫɨʃə̃dɾə
alexandre	əɫɨʃə̃dɾə
alfabetização	alfɐβɨtizɐsɐ̃w̃
alfabeto	aɫfɐβɛtu
alface	aɫfasɨ
alfacinha	aɫfɐsiɲɐ
alfaiate	aɫfɐɪ̯atɨ
alfândega	aɫfɐ̃dɨɣɐ
alfarrábio	aɫfɐʁaβiu
alfarrábio	aɫfɐʁaβju
alfarrábio	aɫfɐʁabiu
alfarrábio	aɫfɐʁabju
alfazema	aɫfɐzemɐ
alfinete	aɫfinɛti
alfisol	alfisɔl
alforge	aɫfɔɾʒɨ
alforria	aɫfuʁiɐ
alforriar	aɫfuʁjɐɾ
algaravia	aɫɣɐɾɐviɐ
alghero	alɡɛɾu
algibeira	aɫʒiβɐjɾɐ
algo	aɫɣu
alguém	aɫɡɐ̃j̃
alguma	alɡumɐ
algumas	alɡumɐʃ
alguns	alɡũʃ
algures	aɫɣuɾɨʃ
alhear	ɐʎjaɾ
alheio	ɐʎɐju
alheio	ɐʎeju
alho	aʎu
alhur	ɐʎuɾ
alhures	ɐʎuɾɨʃ
ali	ɐli
aliado	ɐljaðu
aliança	aliɐ̃sa
aliança	aliɐ̃sɐ
aliança	ɐljɐ̃sɐ
aliás	ɐljaʃ
alicerce	ɐlisɛɾsɨ
alijó	ɐliʒɔ
alínea	ɐlinjɐ
alinhado	ɐliɲaðu
alinhamento	ɐliɲɐmẽtu
alinhar	ɐliɲaɾ
alisar	ɐlizaɾ
alívio	ɐliviu
alívio	ɐlivju
aljezur	ɐɫʒɨzuɾ
aljôfar	aɫʒofaɾ
aljustrel	ɐɫʒuʃtɾɛɫ
alma	aɫmɐ
almada	ɐɫmaðɐ
almanaque	aɫmɐnakɨ
almas	aɫmɐʃ
almeida	aɫmejðɐ
almeirim	ɐɫmɐjɾĩ
almoçar	aɫmusaɾ
almoço	aɫmosu
almoço	aɫmɔsu
almodôvar	aɫmudovaɾ
almofada	aɫmufaðɐ
almude	aɫmuðɨ
alongamento	ɐlõɡɐmẽtu
alongar	ɐlõɡaɾ
alperce	aɫpɛɾsɨ
alperche	aɫpɛɾʃɨ
alpiarça	ɐɫpiaɾsɐ
alpinismo	aɫpiniʒmu
alpinista	aɫpiniʃtɐ
alta	aɫtɐ
altar	aɫtaɾ
altas	aɫtɐʃ
altear	aɫtjaɾ
altera	aɫtɛɾa
alternado	aɫtɨɾnaðu
alternar	aɫtɨɾnaɾ
alternativa	aɫtɨɾnɐtivɐ
alteza	aɫtezɐ
altitude	aɫtituðɨ
alto	aɫtu
altos	aɫtuʃ
altura	aɫtuɾɐ
aluado	ɐlwaðu
alucinar	ɐlusinaɾ
aludir	ɐluðiɾ
alugado	ɐluɣaðu
alugar	ɐluɡaɾ
aluguer	ɐluɡɛɾ
alumiado	ɐlumjaðu
alumiar	ɐlumjaɾ
aluno	ɐlunu
alva	aɫvɐ
alvaiázere	aɫvɐjazɨɾɨ
alves	aɫvɨʃ
alvíssaras	aɫvisɐɾɐʃ
alvito	ɐɫvitu
alvo	aɫvu
alvor	aɫvoɾ
alvoroço	aɫvuɾosu
alvoroço	aɫvuɾɔsu
ama	ɐmɐ
amado	ɐmaðu
amadora	ɐmɐðoɾɐ
amadora	ɐmɐðoɾɐ
âmago	ɐmɐɣu
amainar	ɐmajnaɾ
amanhã	amɐɲɐ̃
amanhecer	ɐmɐɲɨseɾ
amansador	ɐmɐ̃sɐðoɾ
amansar	ɐmɐ̃saɾ
amante	ɐmɐ̃tɨ
amapá	ɐmɐpa
amar	amar
amar	ɐmaɾ
amaral	ɐmɐɾaɫ
amarante	ɐmɐɾɐ̃tɨ
amarelar	ɐmɐɾɨlaɾ
amarelo	ɐmɐɾɛlu
amares	ɐmaɾɨʃ
amares	ɐmaɾɨʃ
amargamente	ɐmaɾɣɐmẽtɨ
amargo	ɐmaɾɣu
amargura	ɐmɐɾɣuɾɐ
amarone	ɐmɐɾonɨ
amassar	ɐmɐsaɾ
amaterasu	ɐmɐtɨɾɐsu
amável	ɐmavɛɫ
amazonas	ɐmɐzonɐʃ
amazônia	amazonja
âmbar	ɐ̃baɾ
ambas	ɐ̃bɐʃ
ambição	ɐ̃bisɐ̃w̃
ambiente	ɐ̃bjẽtɨ
ambíguo	ɐ̃biɣwu
âmbito	ɐ̃bitu
ambos	ɐ̃buʃ
ambulância	ɐ̃bulɐ̃sjɐ
ameaça	ɐmjasɐ
amedrontar	ɐmɨðɾõtaɾ
ameixa	ɐmɐjʃɐ
amém	amɐ̃j̃
amém	amẽj̃
amém	amɛn
amendoim	ɐmẽdwĩ
ameno	ɐmenu
américa	amɛɾikɐ
americano	ameɾikɜnu
amieiro	ɐmjɐjɾu
amieiro	ɐmjejɾu
amiga	ɐmiɣɐ
amigar	ɐmiɣaɾ
amigável	ɐmiɣavɛɫ
amígdala	ɐmiɣðɐlɐ
amigdalite	ɐmiɣðɐlitɨ
amigo	ɐmiɣu
amigos	ɐmiɣuʃ
amiúde	ɐmjudɨ
amizade	ɐmizaðɨ
amnistia	ɐmniʃtiɐ
amo	ɐmu
amolar	ɐmulaɾ
amolecer	ɐmulɨseɾ
amolgar	ɐmoɫɡaɾ
amor	ɐmoɾ
amora	ɐmɔɾɐ
amores	ɐmoɾɨʃ
amplo	ɐ̃plu
ampola	ɐ̃polɐ
ampulheta	ɐ̃puʎetɐ
amuleto	ɐmuletu
amurca	ɐmurkɐ
ana	ɐnɐ
anadia	ɐnɐðiɐ
analisar	ɐnɐlizaɾ
análise	ɐnalizɨ
ananás	ɐnɐnaʃ
anarquia	anaɾkiɐ
ancho	ɐ̃ʃu
ancião	ɐ̃siɐ̃w
ancinho	ɐ̃siɲu
ancora	ɐ̃kɔɾɐ
âncora	ɐ̃kuɾɐ
ancorar	ɐ̃kuɾaɾ
anda	ɐ̃dɐ
andaime	ɐ̃dajmɨ
andam	ɐ̃dɐ̃w̃
andando	ɐ̃dɐ̃du
andante	ɐ̃dɐ̃tɨ
andar	ɐ̃daɾ
andas	ɐ̃dɐʃ
andava	ɐ̃davɐ
ando	ɐ̃du
andor	ɐ̃dor
andorinha	ɐ̃duɾiɲɐ
andorra	ɐ̃doʁɐ
andou	ɐ̃dow
andrajo	ɐ̃dɾaʒu
andrajoso	ɐ̃dɾaʒozo
andré	ɐ̃dɾɛ
anedota	ɐnɯ̽ðɔtɐ
anedótico	ɐnɨðɔtiku
anel	ɐnɛɫ
anexo	ɐnɛksu
ânfora	ɐ̃fuɾɐ
angola	ɐ̃ɡɔlɐ
anguila	ɐ̃ɡilɐ
angular	ɐ̃ɡulaɾ
ângulo	ɐ̃ɡulu
ângulo	ɐ̃ɡulu
anguloso	ɐ̃ɡulozu
angústia	ɐ̃ɡuʃtjɐ
anho	ɐɲu
anil	ɐniɫ
animado	ɐnimaðu
animal	ɐnimaɫ
animar	ɐnimaɾ
anime	animi
animê	anime
ânimo	ɐnimu
animosidade	ɐnimuziðaðɨ
aninhado	ɐniɲaðu
aninhar	ɐniɲaɾ
aniquilar	ɐnikilaɾ
anjo	ɐ̃ʒu
anjos	ɐ̃ʒuʃ
ano	ɐnu
anoitecer	ɐnojtɨseɾ
anomalia	ɐnɔmɐliɐ
anormal	ɐnɔɾmaɫ
anos	ɐnuʃ
anotação	ɐnutɐsɐ̃w̃
anotador	ɐnutɐðoɾ
anotar	ɐnutaɾ
ânsia	ɐ̃sjɐ
ansião	ɐ̃siɐ̃w
ansim	ɐ̃sĩ
ansiosamente	ɐ̃sjɔzɐmẽtɨ
ansioso	ɐ̃sjozu
anta	ɐ̃tɐ
antanho	ɐ̃tɐɲu
antano	ɐ̃tɐnu
antebraço	ɐ̃tɨbɾasu
antecâmara	ɐ̃tɨkɐmɐɾɐ
anteontem	ɐ̃tjõtɐ̃j̃
anteontem	ɐ̃tjõtẽj̃
antepassado	ɐ̃tɨpɐsaðu
antepassados	ɐ̃tɨpɐsaðuʃ
antes	ɐ̃tɨʃ
anticonstitucionalissimamente	ɐ̃tikõʃtitusjunɐlisimɐmẽtɨ
anticultural	ɐ̃tikuɫtuɾaɫ
antífona	ɐ̃tifunɐ
antifonário	ɐ̃tifunaɾju
antiga	ɐ̃tiɣɐ
antigamente	ɐ̃tiɣɐmẽtɨ
antigo	ɐ̃tiɣu
antigos	ɐ̃tiɣuʃ
antiguidade	ɐ̃tiɣwiðaðɨ
antimonárquico	ɐ̃timunaɾkiku
antimoral	ɐ̃timuɾaɫ
antiquário	ɐ̃tikwaɾju
antitético	ɐ̃titɛtiku
antontem	ɐ̃tõtɐ̃j̃
antontem	ɐ̃tõtẽj̃
antropofagia	ãtɾopofaʒia
anual	ɐnuaɫ
anual	ɐnwaɫ
anuência	anuẽsja
anuir	ɐnwiɾ
anunciar	ɐnũsjaɾ
anzol	ɐ̃zɔɫ
ao	aw
aonde	ɐõdɨ
aos	awʃ
aosta	ɐɔʃtɐ
apagado	ɐpɐɣaðu
apagar	ɐpɐɣaɾ
apaixonado	ɐpajʃunaðu
aparafusar	ɐpɐɾɐfuzaɾ
aparato	ɐpɐɾatu
aparatoso	ɐpɐɾɐtozu
aparece	ɐpɐɾɛsɨ
aparecer	ɐpɐɾɨseɾ
apareceu	ɐpɐɾɨsew
aparecia	ɐpɐɾɨsiɐ
aparecimento	ɐpɐɾɨsimẽtu
aparência	ɐpɐɾẽsjɐ
aparentar	ɐpɐɾẽtaɾ
aparente	ɐpɐɾẽtɨ
aparição	ɐpɐɾisɐ̃w̃
apartamento	ɐpɐɾtɐmẽtu
apatetado	apatetadu
apavorado	ɐpɐvuɾaðu
apavorar	ɐpɐvuɾaɾ
apenas	ɐpenɐʃ
aperfeiçoar	ɐpeɹfejsoaɾ
aperrear	ɐpɨʁjaɾ
apertado	ɐpɨɾtaðu
apertando	ɐpɨɾtɐ̃du
apertar	ɐpɨɾtaɾ
aperto	ɐpeɾtu
aperto	ɐpɛɾtu
apesar	ɐpɨzaɾ
apetite	ɐpɨtitɨ
aplauso	ɐplawzu
aplicar	ɐplikaɾ
apócrifo	ɐpɔkɾifu
apoio	ɐpoju
apontar	ɐpõtaɾ
aporrinhação	apohiɲasɐ̃w̃
aportar	ɐpuɾtaɾ
após	ɐpɔʃ
aposentar	ɐpuzẽtaɾ
aposento	ɐpuzẽtu
aposentos	ɐpuzẽtuʃ
apóstolo	ɐpɔʃtulu
apóstolos	ɐpɔʃtuluʃ
aprazer	ɐpɾɐzeɾ
aprazível	ɐpɾɐzivɛɫ
apreciador	ɐpɾɨsjɐðoɾ
apreciar	ɐpɾɨsjaɾ
apreço	ɐpɾesu
apreço	ɐpɾɛsu
aprender	ɐpɾẽdeɾ
aprendiz	ɐpɾẽdiʃ
aprendizagem	ɐpɾẽdizaʒɐ̃j̃
apresentação	ɐpɾɨzẽtɐsɐ̃w̃
apresentado	ɐpɾɨzẽtaðu
apresentar	ɐpɾɨzẽtaɾ
apressado	ɐpɾɨsaðu
apressar	ɐpɾɨsaɾ
aprimorar	apɾimoɾaɾ
aprimorar	apɾimoɾaχ
aprofundar	ɐpɾufũdaɾ
aprontar	ɐpɾõtaɾ
apropriado	ɐpɾupɾjaðu
aprovado	ɐpɾuvaðu
aprovar	ɐpɾuvaɾ
aproveitar	ɐpɾuvɐjtaɾ
aproximação	ɐpɾɔsimɐsɐ̃w̃
aproximadamente	ɐpɾɔsimaðɐmẽtɨ
aproximar	ɐpɾɔsimaɾ
aproximou	ɐpɾɔsimow
apurar	ɐpuɾaɾ
aquário	ɐkwaɾju
aquela	ɐkɛlɐ
àquela	akɛlɐ
aquelas	ɐkɛlɐʃ
àquelas	akɛlɐʃ
aquele	ɐkelɨ
aqueles	ɐkelɨʃ
àqueles	akelɨʃ
aquém	akɐ̃j̃
aquém	akẽj̃
aqui	ɐki
aquilo	ɐkilu
àquilo	akilu
ar	aɾ
árabe	aɾɐβɨ
arábico	ɐɾaβiku
arado	ɐɾaðu
aragem	ɐɾaʒɐ̃j̃
aragem	ɐɾaʒẽj̃
arame	ɐɾɐmɨ
arando	ɐɾɐ̃du
aranha	ɐɾɐɲɐ
arar	ɐɾaɾ
arau	ɐɾaw
araújo	aɾauʒu
arbitramento	ɐɾβitɾɐmẽtu
árbitro	aɾβitɾu
arborizar	ɐɾβuɾizaɾ
arbusto	ɐɾβuʃtu
arca	aɾkɐ
arcabuz	aɾkɐbuʃ
arcanjo	ɐɾkɐ̃ʒu
arcano	ɐɾkɐnu
archote	ɐɾʃɔtɨ
arco	aɾku
ardente	ɐɾdẽtɨ
arder	ɐɾdeɾ
ardina	ɐɾðinɐ
ardor	ɐɾðoɾ
ardósia	aɾdɔziɐ
ardósia	aχdɔzjɐ
área	aɾjɐ
arena	ɐɾenɐ
ares	aɾɨʃ
arezzo	ɐɾɛtɨsu
arganil	ɐɾɣɐniɫ
argila	ɐɾʒilɐ
argola	aɾɡɔla
argola	aʁɡɔla
arguido	ɐɾɣwiðu
arguir	ɐɾɣwiɾ
argumentação	ɐɾɣumẽtɐsɐ̃w̃
argumentador	ɐɾɣumẽtɐðoɾ
argumentar	ɐɾɣumẽtaɾ
argumentista	ɐɾɣumẽtiʃtɐ
arma	aɾmɐ
armação	ɐɾmɐsɐ̃w̃
armada	ɐɾmaðɐ
armado	ɐɾmaðu
armador	ɐɾmɐðoɾ
armamar	ɐɾmɐmaɾ
armamentista	aɾmamẽtʃista
armamentista	aʁmamẽtʃijʃta
armamento	ɐɾmɐmẽtu
armar	ɐɾmaɾ
armário	ɐɾmaɾju
armas	aɾmɐʃ
armazém	ɐɾmɐzɐ̃j̃
armazenar	ɐɾmɐzɨnaɾ
arménia	ɐɾmɛniɐ
arménia	ɐɾmɛnjɐ
arminho	ɐɾmiɲu
aro	aɾu
aroma	ɐɾomɐ
arouca	ɐɾowkɐ
arpão	ɐɾpɐ̃w̃
arqueiro	aɾkɐjɾu
arquipélago	ɐɾkipɛlɐɣu
arquitetura	ɐɾkitɛtuɾɐ
arrabalde	ɐʁɐβaɫðɨ
arraiolos	ɐʁɐjɔluʃ
arrais	ɐʁajʃ
arrancar	ɐʁɐ̃kaɾ
arranhar	ɐʁɐɲaɾ
arranjado	ɐʁɐ̃ʒaðu
arranjar	ɐʁɐ̃ʒaɾ
arranjo	ɐʁɐ̃ʒu
arrastado	ɐʁɐʃtaðu
arrastando	ɐʁɐʃtɐ̃du
arrastar	ɐʁɐʃtaɾ
arrazoar	ɐʁɐzwaɾ
arrebentar	ɐʁɨβẽtaɾ
arrebol	ɐʁɨβɔɫ
arrecadar	ɐʁɨkɐðaɾ
arredores	ɐʁɨðɔɾɨʃ
arrefecer	ɐʁɨfɛseɾ
arrefecimento	ɐʁɨfɛsimẽtu
arregaçar	ɐʁəɡɐsaɾ
arregalar	ɐʀɘɡɐlaɾ
arregimentar	aʁeʒimẽtaɾ
arregimentar	aʁeʒimẽtaʁ
arremedar	ɐʁɨmɨðaɾ
arremete	aʁemɛtʃi
arrente	axẽti
arrente	aʁẽti
arrepender	ɐʁɨpẽdeɾ
arrependido	ɐʁɨpẽdiðu
arrependimento	ɐʁɨpẽdimẽtu
arrepiado	ɐʁɨpjaðu
arrepiante	ɐʁɨpjɐ̃tɨ
arrepiar	ɐʁɨpjaɾ
arrepio	ɐʁɨpiu
arriba	ɐʁiβɐ
arritmia	ɐʁitmiɐ
arroba	ɐʁobɐ
arrojo	ɐʁoʒu
arrombar	ɐʁõbaɾ
arrombar	ɐrõbaɾ
arronches	ɐʁõʃɨʃ
arroz	ɐʁoʃ
arrozal	ɐʁuzaɫ
arruaça	aʁuasa
arrumar	ɐʁumaɾ
arrumar	ɐrumaɾ
arte	aɾtɨ
artes	aɾtɨʃ
artículo	ɐɾtikulu
artificial	ɐɾtifisjaɫ
artilharia	ɐɾtiʎɐɾiɐ
artista	ɐɾtiʃtɐ
árvore	aɾvuɾɨ
arvoredo	ɐɾvuɾeðu
arvoredos	ɐɾvuɾeðuʃ
árvores	aɾvuɾɨʃ
as	ɐʃ
às	aʃ
ás	aʃ
asa	azɐ
asar	ɐzaɾ
asas	azɐʃ
ascensão	ɐʃsẽsɐ̃w̃
ascenso	ɐʃsẽsu
asfalto	ɐʃfaɫtu
asilo	ɐzilu
asinha	ɐziɲɐ
asma	aʒmɐ
asneira	ɐʒnɐjɾɐ
asno	aʒnu
aspa	aʃpɐ
aspecto	ɐʃpɛtu
aspecto	ɐʃpɛktu
áspero	aʃpɨɾu
assado	ɐsaðu
assalariado	ɐsɐlɐɾjaðu
assaltante	ɐsaɫtɐ̃tɨ
assaltar	ɐsaɫtaɾ
assalto	ɐsaɫtu
assar	ɐsaɾ
assassinato	ɐsɐsinatu
assassínio	ɐsɐsinju
assédio	ɐsɛðju
assegurar	ɐsɨɣuɾaɾ
asseio	ɐsɐju
assemelhar	ɐsɨmɨʎaɾ
assentar	ɐsẽtaɾ
assento	ɐsẽtu
asserção	ɐsɨɾsɐ̃w̃
assessor	asesoɹ
assessor	asesoχ
assessorar	asesoɾaɹ
assessorar	asesoɾaχ
assessoria	asesoɾia
assim	ɐsĩ
assimilação	ɐsimilɐsɐ̃w̃
assinalado	ɐsinɐlaðu
assinalar	ɐsinɐlaɾ
assinar	ɐsinaɾ
assistência	ɐsiʃtẽsjɐ
assistir	ɐsiʃtiɾ
asso	asu
assoalho	ɐswaʎu
assobiar	ɐsuβjaɾ
assobio	ɐsuβiu
associação	ɐsusjɐsɐ̃w̃
assombrado	ɐsõbɾaðu
assombro	ɐsõbɾu
assunto	ɐsũtu
assur	asuɾ
assustado	ɐsuʃtaðu
assustar	ɐsuʃtaɾ
astro	astɾu
astro	ajʃtɾu
astrofísica	aʃtɾɔfizikɐ
astrolábio	ɐʃtɾɔlaβju
astroso	ɐʃtɾozu
astúcia	ɐʃtusjɐ
atacante	ɐtɐkɐ̃tɨ
atacar	ɐtɐkaɾ
atado	ɐtaðu
atalhar	ɐtɐʎaɾ
ataque	ɐtakɨ
atar	ɐtaɾ
atarracado	ataʁakadu
atarracar	ataʁakaɾ
atarraxar	ɐtɐʁɐʃaɾ
até	ɐtɛ
ateísmo	ɐtiiʒmu
atempar	ɐtẽpaɾ
atenção	ɐtẽsɐ̃w̃
ateniense	ɐtɨnjẽsɨ
atentado	ɐtẽtaðu
aterrado	ɐtɨʁaðu
aterrar	ɐtɨʁaɾ
aterro	ɐteʁu
aterro	ɐtɛʁu
atirador	ɐtɨɾɐðoɾ
atirando	ɐtiɾɐ̃du
atirou	ɐtiɾow
atitude	ɐtituðɨ
ativador	ativɐðoɾ
ativamente	ativɐmẽtɨ
ativar	ativaɾ
ativista	ativiʃtɐ
ativo	ativu
atlas	atlɐʃ
atleta	ɐtlɛtɐ
atmosfera	atmoʃfɛra
ato	atu
átomo	atumu
ator	atoɾ
atração	ɐtɾasɐ̃w̃
atraente	ɐtɾɐẽtɨ
atrair	ɐtɾɐiɾ
atrapalhada	ɐtɾɐpɐʎaðɐ
atrapalhado	ɐtɾɐpɐʎaðu
atrapalhar	ɐtɾɐpɐʎaɾ
atrasado	ɐtɾɐzaðu
atrasar	ɐtɾɐzaɾ
atraso	ɐtɾazu
atrativo	ɐtɾativu
através	ɐtɾɐvɛʃ
atravessado	ɐtɾɐvɨsaðu
atravessar	ɐtɾɐvɨsaɾ
atrever	ɐtrəver
atribuir	ɐtɾiβwiɾ
átrio	atɾɨu
atriz	ɐtɾiʃ
atual	ɐtwaɫ
atualidade	ɐtwɐliðaðɨ
atualmente	ɐtwaɫmẽtɨ
atuar	ɐtwaɾ
atum	ɐtũ
aturar	atuɾaʁ
audaz	awðaʃ
audição	awðisɐ̃w̃
auga	awɡɐ
aula	awɫɐ
aulas	awlɐʃ
aumento	awmẽtu
aurélio	awɾɛlju
áureo	awɾju
auréola	awɾɛulɐ
aurora	awɾɔɾɐ
ausência	awzẽsjɐ
austeridade	awʃtɨɾiðaðɨ
austero	awʃtɛɾu
áustria	awʃtɾjɐ
austro	awʃtɾu
autenticidade	awtẽtisiðaðɨ
auto	awtu
autocarro	awtɔkaʁu
autoestima	awtɔiʃtimɐ
autoestima	awtɔʃtimɐ
autoestrada	awtɔiʃtɾaðɐ
autoestrada	awtɔʃtɾaðɐ
autoevidente	awtwividẽtɨ
automático	awtumatiku
automatizar	awtumɐtizaɾ
autómato	awtɔmɐtu
autor	awtoɾ
autoria	awtuɾiɐ
autoridade	awtuɾiðaðɨ
autorização	awtuɾizɐsɐ̃w̃
autorizar	awtuɾizaɾ
autorretrato	awtɔʁɨtɾatu
avaliação	ɐvɐljɐsɐ̃w̃
avaliar	ɐvɐljaɾ
avançar	ɐvɐ̃saɾ
avanço	avɐ̃su
avariado	ɐvɐɾjaðu
ave	avɨ
ave	avɛ
ave	avɨ
aveia	ɐvɐjɐ
aveia	ɐvejɐ
aveiro	avejɾu
avelã	ɐvɨlɐ̃
avenida	ɐvɨniðɐ
avental	ɐvẽtaɫ
averiguar	ɐvɨɾiɣwaɾ
aversão	ɐvɨɾsɐ̃w̃
aves	avɨʃ
avião	ɐvjɐ̃w̃
avis	ɐviʃ
avisar	ɐvizaɾ
avistar	ɐviʃtaɾ
avó	ɐvɔ
avô	ɐvo
avondança	ɐvõdɐ̃sɐ
avós	ɐvɔʃ
azambuja	ɐzɐ̃buʒɐ
azar	ɐzaɾ
azeite	ɐzɐjtɨ
azeite	ɐzejtɨ
azeiteiro	ɐzɐjtɐjɾu
azeiteiro	ɐzejtejɾu
azerbaijão	ɐzɨɾβɐjʒɐ̃w̃
azereiro	ɐzɨɾɐjɾu
azereiro	ɐzɨɾejɾu
azevedo	ɐzɨveðu
azevinho	ɐzɨviɲu
azia	ɐziɐ
azinhaga	ɐziɲaɣɐ
azinheira	ɐziɲɐjɾɐ
azinheira	ɐziɲejɾɐ
azuis	ɐzujʃ
azul	ɐzuɫ
azulejo	ɐzulɐjʒu
azulejo	ɐzulɛʒu
azulejo	ɐzuleʒu
azulejos	ɐzulɐjʒuʃ
azulejos	ɐzulɛʒuʃ
azulejos	ɐzuleʒuʃ
azur	ɐzuɾ
b.o.	beɔ
baba	babɐ
babau	babaw
baboseira	babozejɾa
bacalhau	bɐkɐʎaw
bacharel	bɐʃɐɾɛɫ
bachquir	baʃkɨɾ
bacia	bɐsiɐ
baço	basu
bácoro	bakuɾu
báculo	bakulu
bada	badɐ
badalo	bɐðalu
bafo	bafu
bagaço	bɐɣasu
bagel	bɛjɣɨl
bagre	baɣɾɨ
baguete	baɡɛtʃi
baía	bɐiɐ
baiano	bajɐ̃nu
baião	bajɐ̃w
baião	bajɐ̃w
baical	bajkaɫ
bailanta	bɐjlãta
bailarina	bajlɐɾinɐ
bailarino	bajlɐɾinu
bairro	bajʁu
baixa	bajʃɐ
baixando	bajʃɐ̃du
baixar	bajʃaɾ
baixo	bajʃu
bala	balɐ
balaço	balasu
balada	bɐlaðɐ
balança	bɐlɐ̃sɐ
balançar	bɐlɐ̃saɾ
balão	bɐlɐ̃w̃
balázio	balazju
baldaquino	baɫðɐkinu
balde	baɫdɨ
baldio	baɫdiu
baleia	bɐlɐjɐ
baleia	bɐlejɐ
baliza	bɐlizɐ
balzaquiana	balzɐkjɐnɐ
bambu	bɐ̃bu
banana	bɐnɐnɐ
bancar	bɐ̃ᵑkaɾ
bancar	bɐ̃ᵑkaχ
banco	bɐ̃ku
banda	bɐ̃dɐ
bandeira	bɐ̃dɐjɾɐ
bandeja	bɐ̃deʒɐ
bandicoot	bɐ̃dikutɨ
bandido	bɐ̃diðu
bando	bɐ̃du
bandolim	bɐ̃dulĩ
banguela	bɐ̃ɡɛlɐ
banhar	bɐɲaɾ
banheira	bɐɲɐjɾɐ
banheiro	bɐɲɐjɾu
banho	bɐɲu
banir	bɐniɾ
banquete	bɐ̃ketɯ
banzo	bɐ̃zu
bão	bɐ̃w̃
bar	baɾ
baraço	baɾasu
baralho	bɐɾaʎu
barato	bɐɾatu
barba	baɾβɐ
barbas	baɾβɐʃ
barbeiro	bɐɾβɐjɾu
barca	baɾkɐ
barcelos	bɐɾsɛluʃ
barco	baɾku
bardo	baɾdu
barlavento	baɾlɐvẽtu
barman	bɐɾmɛ̃
barqueiro	bɐɾkɐjɾu
barqueiro	bɐɾkejɾu
barra	baʁɐ
barraca	bɐʁakɐ
barrancos	bɐʁɐ̃kuʃ
barrancos	bɐʁɐ̃kuʃ
barregã	bɐʁɨɣɐ̃
barreira	bɐʁɐjɾɐ
barreiro	bɐʁɐjɾu
barreiro	bɐʁɐjɾu
barriga	bɐʁiɡɐ
barril	bɐʁiɫ
barro	baʁu
barulho	bɐɾuʎu
basalto	bɐzaɫtu
basco	baʃku
base	bazɨ
básico	baziku
basílica	bɐzilikɐ
basta	baʃtɐ
bastante	bɐʃtɐ̃tɨ
bastão	bɐʃtɐ̃w̃
bastar	bɐʃtaɾ
bastardo	bɐʃtaɾðu
batalha	bɐtaʎɐ
batalha	bɐtaʎɐ
batata	bɐtatɐ
batel	bɐtɛɫ
batendo	bɐtẽdu
bater	bɐteɾ
bateu	bɐtew
batia	bɐtiɐ
batina	bɐtinɐ
batismo	batiʒmu
batista	batʃistɐ
batizado	batizaðu
batizar	bɐtizaɾ
batom	bɐtõ
baú	bau
bazar	bɐzaɾ
bazófia	bazɔfja
bê	be
bebe	bɛbi
bebé	bɛβɛ
bêbedo	beβɨðu
beber	bɨβeɾ
bebida	bɨβiðɐ
bebo	bebu
beco	beku
bege	bɛʒi
beicinho	bɐjsiɲu
beiço	bɐjsu
beijar	bejʒaɾ
beijo	bɐjʒu
beijo	bejʒu
beijos	bɐjʒuʃ
beijos	bejʒuʃ
beira	bɐjɾɐ
beja	bɛʒɐ
bela	bɛlɐ
beladona	bɛlɐdonɐ
belas	bɛlɐʃ
beleza	bɨlezɐ
belezura	belezuɾa
belga	bɛɫɣɐ
bélgica	bɛɫʒikɐ
bélico	bɛliku
beliz	bɨliʃ
belmonte	bɛɫmõtɨ
belo	bɛlu
belos	bɛluʃ
bem	bɐ̃j̃
bemol	bemɔɫ
benavente	bɨnɐvẽtɨ
bênção	bẽsɐ̃w̃
bênçãos	bẽsɐ̃ũ̯ʃ
bendição	bẽdisɐ̃w̃
beneficiar	bɨnɨfisjaɾ
benefício	bɨnɨfisju
bengala	bẽɡalɐ
bengali	bẽɡali
bens	bɐ̃j̃ʃ
bento	bẽtu
bento	bẽtu
benvindo	bɐ̃j̃vĩdu
benvindo	bẽj̃vĩdu
benzeno	bẽzenu
benzer	bẽzeɾ
beque	bɛkɯ
berça	beɾsɐ
berço	beɾsu
berilo	bɯɾilu
beringela	bɨɾĩʒɛlɐ
bermuda	bɨɾmuðɐ
bermudas	bɨɾmuðɐʃ
berquélio	bɯɾkɛliu
besouro	bɨzowɾu
besouro	bɨzoɾu
besta	beʃtɐ
besta	bɛʃtɐ
besta	bɛʃtɐ
bestas	beʃtɐʃ
bestial	bɨʃtjaɫ
betão	bɨtɐ̃w̃
betar	betaɾ
betar	betaχ
bete	bɛtʃi
beterraba	bɨtɨʀabɐ
betinho	bɛtiɲu
betume	bɨtumɨ
bexiga	bɨʃiɣɐ
bezerro	bɨzeʁu
biberão	biβɨɾɐ̃w̃
bíblia	biβljɐ
bíblia	biβljɐ
bibliógrafo	biβliɔɣɾɐfu
biblioteca	biβljutɛkɐ
bibliotecário	biβljutɨkaɾju
bicar	bikaɾ
bicha	biʃɐ
bicho	biʃu
bicla	biklɐ
bico	biku
bicos	bikuʃ
bidé	bidɛ
bielorrússia	bjɛlɔʁusjɐ
bienal	bienaɫ
biênio	bienju
bife	bifɨ
bigode	biɣɔðɨ
bigodes	biɣɔðɨʃ
bigorna	biɡɔɾnɐ
bilha	biʎɐ
bilhar	biʎaɾ
bilhete	biʎetɨ
bilhetes	biʎetɨʃ
bilro	bilʁu
biombo	bjõbu
biónico	bioniku
biônico	bioniku
bípede	bipedʒi
bis	biʃ
bisavó	bizɐvɔ
bisavô	bizɐvo
bisbilhotice	biʒβilutisɨ
biscoito	biʃkojtu
bispo	biʃpu
bit	bit͡ʃi
bit	biti
bitaite	bitajtɨ
bituca	bitukɐ
blenda	blẽdɐ
blica	blika
blocagem	blokaʒẽj̃
bloco	blɔku
bloquear	blukjaɾ
boa	boɐ
boas	boɐʃ
bobinar	buβinaɾ
bobo	bobu
boca	bokɐ
bocadinho	bukɐðiɲu
bocado	bukaðu
boçal	bosaɫ
boçal	bosaw
bocejar	busɨʒaɾ
bocejo	busɐʒu
bocejo	busɐjʒu
bochecha	buʃɐjʃɐ
boco	boku
bocó	bokɔ
boda	boðɐ
bode	bɔˑðɨ
boi	boj
boiadeiro	bojadejɾu
bois	bojʃ
bola	bɔlɐ
bolacha	bulaʃɐ
bolas	bɔlɐʃ
boleia	bulɐjɐ
boleia	bulejɐ
boleto	buletu
bolha	boʎɐ
boliche	buliʃɨ
bolo	bolu
bolota	bulɔtɐ
bolsa	boɫsɐ
bolso	boɫsu
bolsominion	bowsominjõ
bolsominion	bowsominiõ
bolsos	bɔɫsuʃ
bom	bõ
bomba	bõbɐ
bombarral	bõbɐʁaɫ
bombeiro	bõbɐjɾu
bombeiro	bõbejɾu
bombom	bõbõ
bonachão	bonaʃɐ̃w̃
bonacheirão	bonaʃejɾɐ̃w̃
bondade	bõdaðɨ
bonde	bõdə
boné	bɔnɛ
boneca	bunɛkɐ
bonina	buninɐ
bonita	bunitɐ
bonito	bunitu
bons	bõʃ
bónus	bɔnuʃ
bope	bɔpi
boquete	bokɛtʃi
boquiaberto	bukjɐβɛɾtu
borba	bɔɾβɐ
borboleta	buɾβuletɐ
borboletário	buɾbulɨtaɾju
borboletear	buɾβulɨtjaɾ
borda	bɔɾðɐ
bordado	buɾðaðu
bordar	buɾðaɾ
bordel	buɾðɛɫ
bordo	bɔɾðu
bordo	boɾðu
bordo	bɔɾðu
boroa	buɾoɐ
borracha	buʁaʃɐ
borrar	buʁaɾ
borzeguim	buɾzɨɣĩ
bósnio	bɔʃniu
bosque	bɔʃkɨ
bota	bɔtɐ
botão	butɐ̃w̃
botar	butaɾ
bote	bɔtɨ
botequim	butɨkĩ
boticário	botʃikaɾju
boticas	butikɐʃ
boticas	butikɐʃ
boto	botu
boto	bɔtu
botões	butõj̃ʃ
bouça	bowsɐ
box	bɔks
braça	bɾasɐ
braçada	bɾɐsaðɐ
braço	bɾasu
braços	bɾasuʃ
braga	bɾaɣɐ
bragança	bɾɐɣɐ̃sɐ
branca	bɾɐ̃kɐ
brancas	bɾɐ̃kɐʃ
branco	bɾɐ̃ku
brancos	bɾɐ̃kuʃ
brandamente	bɾɐ̃dɐmẽtɨ
brando	bɾɐ̃du
brasa	bɾazɐ
brasil	bɾɐziɫ
brasil	bɾɐziɫ
brava	bɾavɐ
bravas	bɾavɐʃ
bravo	bɾavu
bravura	bɾɐvuɾɐ
breca	bɾɛkɐ
brecha	bɾɛʃɐ
bregueço	bɾeɡesu
breja	bɾɛʒa
brejeirar	breʒejɾaɾ
brejeirar	breʒejɾaʁ
brejeirice	breʒejɾisi
brejeiro	bɾeʒejɾu
brejo	bɾɛʒu
brenha	bɾɐjɲɐ
brenha	bɾejɲɐ
bretanha	bɾɨtɐɲɐ
bretão	bɾɨtɐ̃w̃
breu	bɾew
breve	bɾɛvɨ
brevemente	bɾɛvɨmẽtɨ
briga	bɾiɡɐ
brilhando	bɾiʎɐ̃du
brilhante	bɾiʎɐ̃tɨ
brilhar	bɾiʎaɾ
brilho	bɾiʎu
brincadeira	bɾĩkɐðɐjɾɐ
brincar	bɾĩkaɾ
brinco	bɾĩku
brinde	bɾĩdɯ
brinquedo	bɾĩkedu
brisa	bɾizɐ
broa	bɾoɐ
broa	bɾowɐ
brochura	bɾoʃuɾa
bronze	bɾõzɨ
brotar	bɾutaɾ
bruaca	bruaka
bruco	bɾuku
bruços	bɾusuʃ
bruma	bɾumɐ
brunir	bɾuniɾ
bruno	bɾunu
bruscamente	bɾuʃkɐmẽtɨ
brusco	bɾuʃku
brusqueta	bɾuʃketɐ
brutal	bɾutaɫ
brutalidade	bɾutɐliðaðɨ
bruxa	bɾuʃɐ
bucólico	bukɔliku
buda	buðɐ
bué	buɛ
buffet	bife
bufo	bufu
bugar	buɡaɾ
bugiganga	buʒiɡɐ̃ɡɐ
bugio	buʒiu
bula	bulɐ
bulbo	buɫbu
bule	bulɨ
bulgária	buɫɣaɾjɐ
búlgaro	buɫɡɐɾu
bulhufas	buʎufas
bulhufas	buʎufajʃ
bulir	buliɾ
buque	bukɨ
buquê	buke
buraco	buɾaku
burca	buɾkɐ
burgo	buɾɣu
burguês	buɾɣeʃ
burro	buʁu
busão	buzɐ̃w̃
busca	buʃkɐ
buscar	buʃkaɾ
bússola	busulɐ
busto	buʃtu
buxo	buʃu
búzio	buzju
byte	bajtʃi
ç	s
cá	ka
cã	kɐ̃
cabaça	kɐβasɐ
cabaço	kabasu
cabeça	kɐβesɐ
cabeças	kɐβesɐʃ
cabeceira	kɐβɨsɐjɾɐ
cabeleireiro	kɐβɨlɐjɾɐjɾu
cabelo	kɐβelu
cabelos	kɐβeluʃ
caber	kɐβeɾ
cabide	kɐβiðɨ
cabisbaixo	kabiʒbajʃu
cabo	kabu
cabra	kaβɾɐ
caca	kakɐ
caça	kasɐ
caçar	kɐsaɾ
cacareco	kakarɛku
cacau	kɐkaw
cachar	kɐʃaɾ
cachecol	kaʃɨkɔɫ
cachimbo	kɐʃĩbu
cachopa	kɐʃɔpɐ
cachopo	kɐʃopu
cachorro	kɐʃoʁu
cacofonia	kɐkɔfuniɐ
caçula	kɐsulɐ
cada	kɐðɐ
cadaval	kɐðɐvaɫ
cadeado	kɐðjaðu
cadeia	kɐðɐjɐ
cadeira	kɐdɐjɾɐ
cadeira	-dej-
cadeiras	kɐdɐjɾɐʃ
cadela	kɐðɛlɐ
cadência	kadẽsja
caderno	kɐðɛɾnu
cães	kɐ̃j̃ʃ
café	kɐfɛ
cafofo	kafofu
cafoto	kafotu
cafuné	kafunɛ
cágado	kaɣɐðu
cagueta	kaɡweta
cagueta	kaɡwɛta
caguetar	kaɡwetaɾ
caguete	kaɡwɛtʃi
caia	kajɐ
caia	kɐiɐ
cãibra	kɐ̃j̃bɾɐ
caído	kɐiðu
caimão	kajmɐ̃w̃
caindo	kɐĩdu
caio	kaju
caipira	kajpiɾɐ
caipirinha	kajpiɾiɲɐ
cair	kɐiɾ
cais	kajʃ
caiu	kɐiw
caixa	kajʃɐ
caixilho	kajʃiʎu
cajado	kɐʒaðu
caju	kaʒu
cal	kaɫ
calado	kɐlaðu
calados	kɐlaðuʃ
calão	kɐlɐ̃w̃
calar	kɐlaɾ
calcada	kaɫkaðɐ
calçada	kaɫsaðɐ
calcado	kaɫkaðu
calçado	kaɫsaðu
calcâneo	kaɫkɐnju
calcanhar	kaɫkɐɲaɾ
calcar	kaɫkaɾ
calçar	kaɫsaɾ
calças	kaɫsɐʃ
cálcio	kalsju
calculação	kaɫkulɐsɐ̃w̃
caldeirão	kaɫðɐjɾɐ̃w̃
caldo	kaɫdu
calebe	kalɛbi
calendário	kɐlẽdaɾju
calhambeque	kɐʎɐ̃bɛkɘ
calhar	kɐʎaɾ
calhau	kɐʎaw
calheta	kɐʎetɐ
calheta	kɐʎetɐ
cálice	kalisɨ
califa	kɐlifɐ
caligrafia	kɐliɣɾɐfiɐ
calistenia	kalistenia
calma	kaɫmɐ
calmaria	kalmɐɾiɐ
calmo	kaɫmu
calo	kalu
calor	kɐloɾ
calorento	kɐluɾẽtu
caloroso	kɐluɾozu
cama	kɐmɐ
camada	kɐmaðɐ
camada	kɐmadɐ
câmara	kɐmɐɾɐ
cambalhota	kɐ̃bɐʎɔtɐ
câmbio	kɐ̃biu
câmbio	kɐ̃bju
camelo	kɐmelu
camião	kɐmjɐ̃w̃
caminha	kɐmiɲɐ
caminha	kɐmiɲɐ
caminhada	kɐmiɲadɐ
caminhando	kɐmiɲɐ̃du
caminho	kɐmiɲu
caminhos	kɐmiɲuʃ
camisa	kɐmizɐ
camisola	kɐmizɔlɐ
camoniano	kamunjɐnu
campa	kɐ̃pɐ
campainha	kɐ̃pɐiɲɐ
campanário	kɐ̃pɐnaɾju
campanha	kɐ̃pɐɲa
campanha	kɐ̃pɐɲɐ
campeonato	kɐ̃pjunatu
campesino	kɐ̃pɨzinu
campestre	kɐ̃pɛʃtɾɨ
campos	kɐ̃puʃ
camurça	kɐmuɾsɐ
cana	kɐnɐ
canal	kɐnaɫ
canalha	kɐnaʎɐ
canaque	kɐnakɨ
canário	kɐnaɾju
canção	kɐ̃sɐ̃w̃
cancioneiro	kɐ̃sjunɐjɾu
cancioneiro	kɐ̃sjunejɾu
canções	kɐ̃sõj̃ʃ
candeeiro	kɐ̃djɐjɾu
candeia	kɐ̃dɐjɐ
candeia	kɐ̃dejɐ
candelabro	kɐ̃dɨlaβɾu
candil	kɐ̃diɫ
candomblé	kɐ̃dõblɛ
candomblé	kɐ̃dõblɛ
candonga	kɐ̃dõɡɐ
caneca	kɐnɛkɐ
caneta	kɐnetɐ
cangalheiro	kɐ̃ɡɐʎɐjɾu
cangalheiro	kɐ̃ɡɐʎejɾu
canhão	kɐɲɐ̃w̃
canhoto	kɐɲotu
canivete	kanivɛte
canivete	kɐnivɛte
canja	kɐ̃ʒɐ
cano	kɐnu
cansaço	kɐ̃sasu
cansado	kɐ̃saðu
cansar	kɐ̃saɾ
canseira	kɐ̃sejɾa
canso	kɐ̃su
cantador	kɐ̃tɐðoɾ
cantanhede	kɐ̃tɐɲeðɨ
cantão	kɐ̃tɐ̃w̃
cantão	kɐ̃tɐ̃w̃
cantar	kɐ̃taɾ
cântaro	kɐ̃tɐɾu
cante	kɐ̃tɨ
canteiro	kɐ̃tɐjɾu
cântico	kɐ̃tiku
cantiga	kɐ̃tiɣɐ
cantina	kɐ̃tinɐ
canto	kɐ̃tu
cantochão	kɐ̃tuʃɐ̃w̃
cantor	kɐ̃toɾ
cantos	kɐ̃tuʃ
canudo	kɐnuðu
cão	kɐ̃w̃
caos	kawʃ
cãozinho	kɐ̃w̃ziɲu
capa	kapɐ
capacidade	kɐpɐsiðaðɨ
capacitar	kɐpɐsitaɾ
capaz	kɐpaʃ
capela	kɐpɛlɐ
capelão	kɐpɨlɐ̃w̃
capicua	kɐpikuɐ
capitais	kɐpitaiʃ
capital	kɐpitaɫ
capitão	kɐpitɐ̃w̃
capítulo	kɐpitulu
capixaba	kapiʃaba
capoeira	kɐpuɐjɾɐ
capoeira	kɐpwɐjɾɐ
capoeira	kɐpuejɾɐ
capoeira	kɐpwejɾɐ
caprichar	kapɾiʃar
capricho	kɐpɾiʃu
captar	kaptaɾ
capucho	kɐpuʃu
capuz	kɐpuʃ
caquesseitão	kɐkɨsɐjtɐ̃w̃
caquesseitão	kɐkɨsejtɐ̃w̃
cara	kaɾɐ
caracal	kɐɾɐkaɫ
carácter	kɐɾaktɛɾ
carácter	kɐɾatɛɾ
caralho	kɐɾaʎu
caralhos	kəɾalʊʃ
caramba	kɐɾɐ̃bɐ
caramelo	kɐɾɐmɛlu
caraminhola	kaɾamij̃ɔla
carão	kɐɾɐ̃w̃
carapaça	kɐɾɐpasɐ
caráter	kɐɾatɛɾ
caráter	kɐɾaktɛɾ
caravela	kɐɾɐvɛlɐ
carcaça	kɐɾkasɐ
carcanhol	kɐɾkɐɲɔɫ
cárcere	kaɾsɨɾɨ
cardeal	kɐɾdjaɫ
cardiff	kaɾðifɨ
cardume	kɐɾðumɨ
careca	kɐɾɛkɐ
carecer	kɐrəser
carga	kaɾɣɐ
cargo	kaɾɣu
carica	kɐrikɐ
carícia	kɐɾisjɐ
caridade	kɐɾiðaðɨ
carimbar	kɐɾĩbaɾ
carimbo	kɐɾĩbu
carinho	kɐɾiɲu
carmim	kɐɾmĩ
carnal	kɐɾnaɫ
carnaval	kɐɾnɐvaɫ
carne	kaɾnɨ
carneiro	kɐɾnɐjɾu
carneiro	kɐɾnejɾu
carnificina	kɐɾnifisinɐ
caro	kaɾu
caroço	kɐɾosu
carola	kaɾɔla
caronte	kɐɾõtɨ
carpete	kaɾpɛtɨ
carpideira	kɐɾpiðɐjɾɐ
carpideira	kɐɾpiðejɾɐ
carpir	kɐɾpiɾ
carranca	kɐʁɐ̃kɐ
carrapato	kɐʁɐpatu
carrasco	kɐʁaʃku
carregado	kɐʁɨɣaðu
carregar	kɐʁɨɡaɾ
carreira	kɐʁɐjɾɐ
carreiro	kɐʁɐjɾu
carrilhão	kɐʁiʎɐ̃w̃
carrinho	kɐʁiɲu
carro	kaʁu
carroça	kɐʁɔsɐ
carros	kaʁuʃ
carruagem	kɐʁwaʒɐ̃j̃
carta	kaɾtɐ
cartão	kɐɾtɐ̃w̃
cartas	kaɾtɐʃ
cartaxo	kɐɾtaʃu
cartaxo	kɐɾtaʃu
cartaz	kɐɾtaʃ
carteira	kɐɾtɐjɾɐ
carteiro	kɐɾtɐjɾu
cartilha	kɐɾtiʎɐ
cartomante	kaɾtumɐ̃tɨ
cartune	kaɾtũ
cartune	kaɾtunɨ
carvalho	kɐɾvaʎu
carvalho	kɐɾvaʎu
carvão	kɐɾvɐ̃w̃
casa	kazɐ
casaca	kɐzakɐ
casaco	kɐzaku
casal	kɐzaɫ
casamento	kɐzɐmẽtu
casar	kɐzaɾ
casarão	kɐzɐɾɐ̃w̃
casario	kɐzɐɾiu
casas	kazɐʃ
cascais	kɐʃkajʃ
cascais	kɐʃkajʃ
cascata	kɐʃkatɐ
cascavel	kɐʃkɐvɛɫ
casebre	kɐzɛβɾɨ
caseiro	kɐzɐjɾu
caseiro	kɐzejɾu
caserna	kɐzɛɾnɐ
casino	kɐzinu
caso	kazu
casos	kazuʃ
casota	kɐzɔtɐ
casquilho	kaskiʎu
casquilho	kajʃkiʎu
cassete	kasɛtʃi
cassetete	kasɨtɛtɨ
casta	kaʃtɐ
castanho	kɐʃtɐɲu
castelhano	kɐʃtɨʎɐnu
castelo	kɐʃtɛlu
castiçal	kɐʃtisaɫ
castidade	kɐʃtɨðaðɨ
castigar	kɐʃtiɣaɾ
castigo	kɐʃtiɣu
casto	kaʃtu
castrejo	kɐʃtɾɐjʒu
castrejo	kɐʃtɾejʒu
castro	kaʃtɾu
castro	kaʃtɾu
castroverde	kaʃtɾuveɾdɨ
casula	kɐzulɐ
catafalco	kɐtɐfaɫku
cataplana	kɐtɐplɐnɐ
catar	kɐtaɾ
catar	kataʁ
catar	kataʁ
catar	kataɾ
catar	kɐtaɾ
catástrofe	kɐtaʃtɾufɨ
catedral	kɐtɨðɾaɫ
catequista	katekista
catinga	kɐtʃĩɡɐ
catita	kɐtitɐ
cativar	kɐtivaɾ
cativo	kɐtivu
cato	katu
catorze	kɐtoɾzɨ
catraio	kɐtɾaju
cauã	kawɐ̃
cauda	kawðɐ
cauê	kawe
causa	kawzɐ
causar	kawzaɾ
cava	kavɐ
cávado	kavɐðu
cavalaria	kɐvɐlɐɾiɐ
cavaleiro	kɐvɐlɐjɾu
cavaleiro	kɐvɐlejɾu
cavalheiro	kɐvɐʎɐjɾu
cavalo	kɐvalu
cavalos	kɐvaluʃ
cavaquinho	kɐvɐkiɲu
caveira	kavɐjɾɐ
caveira	kavejɾɐ
caviar	kavjaɾ
caxinguelê	kaʃĩɡele
cazaquistão	kazɐkiʃtɐ̃w̃
cê	se
cear	siaɾ
cebola	sebolɐ
cedilha	sɨðiʎɐ
cedo	seðu
cedro	sɛðɾu
cegar	sɨɣaɾ
cego	sɛɣu
cegonha	sɨɣoɲɐ
cegueta	seɡeta
ceia	sɐjɐ
ceia	sejɐ
ceifa	sɐjfɐ
ceifa	sejfɐ
ceifar	sɐjfaɾ
ceifar	sejfaɾ
cela	sɛlɐ
celeiro	sɨlɐjɾu
celeiro	sɨlejɾu
célere	sɛlɨɾɨ
celeste	sɨlɛʃtɨ
celestial	sɨlɨʃtjaɫ
celeuma	sɨlewmɐ
celibato	sɨliβatu
célula	sɛlulɐ
cem	sɐ̃j̃
cem	sẽj̃
cena	senɐ
cénico	sɛniku
cenoira	sɨnojɾɐ
cenoura	sɨnowɾɐ
cenrada	sẽʁaðɐ
censura	sẽsuɾɐ
censurar	sẽsuɾaɾ
centauro	sẽtawɾu
centavo	sẽtavu
centeio	sẽtɐju
centeio	sẽteju
centímetro	sẽtimɨtɾu
cêntimo	sẽtimu
cento	sẽtu
central	sẽtɾaɫ
centro	sẽtɾu
cera	seɾɐ
cerca	seɾkɐ
cerca	sɛɾkɐ
cereal	sɨɾjaɫ
cerebral	sɨɾɨβɾaɫ
cérebro	sɛɾɨβɾu
cereja	sɨɾɐjʒɐ
cereja	sɨɾejʒɐ
cerimónia	sɨɾimɔnjɐ
cerquilha	sərkiʎɐ
cerrado	sɨʁaðu
cerrados	sɨʁaðuʃ
cerrar	sɨʁaɾ
certa	sɛɾtɐ
certamente	sɛɾtɐmẽtɨ
certeza	sɨɾtezɐ
certo	sɛɾtu
certos	sɛɾtuʃ
cerval	sɨɾvaɫ
cerveja	sɨɾveʒɐ
cerveja	sɨɾvejʒɐ
cerveja	sɨɾvɐʒɐ
cerveja	sɨɾvɐjʒɐ
cervo	seɾvu
cervo	sɛɾvu
césar	sɛzɐɾ
cessar	sɨsaɾ
cesto	seʃtu
cetim	sɨtĩ
cetro	sɛtɾu
céu	sɛw
céus	sɛwʃ
ceuta	sewtɐ
cevar	sɨvaɾ
chá	ʃa
chacina	ʃasina
chafariz	ʃɐfɐɾiʃ
chafurdar	ʃɐfuɾðaɾ
chaga	ʃaɣɐ
chaleira	ʃɐlɐjɾɐ
chama	ʃɐmɐ
chama	ʃamɐ
chamado	ʃɐmaðu
chamar	ʃɐmaɾ
chamava	ʃɐmavɐ
chamejar	ʃɐmeʒaɾ
chamejar	ʃɐmeʒaχ
chaminé	ʃɐminɛ
champanha	ʃɐ̃pɐɲɐ
champanhe	ʃɐ̃pɐɲɨ
champô	ʃɐ̃po
chamusca	ʃɐmuʃkɐ
chamusca	ʃɐmuʃkɐ
chamuscar	ʃɐmuʃkaɾ
chance	ʃɐ̃sɨ
chão	ʃɐ̃w̃
chapa	ʃapɐ
chapéu	ʃɐpɛw
charamela	ʃɐɾɐmɛlɐ
charco	ʃaɾku
charneca	ʃɐɾnɛkɐ
charque	ʃaɾkɨ
charrete	ʃaʁɛtʃi
charrete	ʃarɛtʃi
charuto	ʃɐɾutu
chatear	ʃɐtjaɾ
chato	ʃatu
chau	ʃaw
chavão	ʃavɐ̃w̃
chave	ʃavɨ
chavelha	ʃɐveʎɐ
chavelha	ʃɐvɐʎɐ
chávena	ʃavɨnɐ
chaves	ʃavɨʃ
chaves	ʃavɨʃ
checagem	ʃekaʒẽ
chefe	ʃɛfɨ
chefia	ʃɨfiɐ
chega	ʃeɣɐ
chegada	ʃɨɣaðɐ
chegado	ʃɨɣaðu
chegando	ʃɨɣɐ̃du
chegar	ʃɨɡaɾ
chegara	ʃɨɣaɾɐ
chegará	ʃɨɣɐɾa
chegava	ʃɨɣavɐ
chegou	ʃɨɣow
cheia	ʃeɪɐ
cheias	ʃɐjɐʃ
cheio	ʃɐju
cheio	ʃeju
cheios	ʃɐjuʃ
cheirar	ʃɐjɾaɾ
cheirar	ʃejɾaɾ
cheiro	ʃɐjɾu
cheque	ʃɛkɨ
chiar	ʃjaɾ
chiaroscuro	kjaɾuʃkuɾu
chibata	ʃibata
chibo	ʃiβu
chiclete	ʃiklɛtɨ
chico	ʃiku
chicotada	ʃikutaðɐ
chicote	ʃikɔtɨ
chicotear	ʃikutjaɾ
chifre	ʃifɾɨ
chimpanzé	ʃĩpɐ̃zɛ
china	ʃinɐ
chinela	ʃinɛlɐ
chinelas	ʃinɛlɐʃ
chinelo	ʃinɛlu
chinelos	ʃinɛluʃ
chinês	ʃineʃ
chipre	ʃipɾɨ
chiqueiro	ʃikɐjɾu
chita	ʃitɐ
chiumbi	ʃjũɱbɨ
choca	ʃɔkɐ
chocalho	ʃukaʎu
chocar	ʃukaɾ
chocolate	ʃukulatɨ
choque	ʃɔkɨ
chor	ʃoɾ
chorando	ʃuɾɐ̃du
chorar	ʃuɾaɾ
choro	ʃoɾu
choro	ʃɔɾu
choupana	ʃowpɐnɐ
choupo	ʃowpu
chouseira	ʃowzɐjɾɐ
chouseira	ʃowzejɾɐ
chover	ʃuveɾ
chuca	ʃuka
chuço	ʃusu
chuinga	ʃuĩɡa
chuiva	ʃujvɐ
chulca	ʃuwka
chulipa	ʃulipɐ
chumbaram	ʃũbaɾɐ̃w̃
chumbo	ʃũbu
chupeta	ʃupetɐ
chutar	ʃutaɾ
chuto	ʃutu
chuva	ʃuvɐ
chuveiro	ʃuvɐjɾu
chuvisco	ʃuviʃku
chuvoso	ʃuvozu
cicatriz	sikatɾis
cidadão	siðɐðɐ̃w̃
cidade	siðaðɨ
ciência	sjẽsjɐ
científico	sjẽtifiku
cientista	sjẽtiʃtɐ
cifrão	sifɾɐ̃w̃
cigarro	siɣaʁu
cilha	siʎɐ
cilindrar	sɨlĩdɾaɾ
cílio	silju
cima	simɐ
cimento	simẽtu
cimitarra	simɨtaʁɐ
cinamomo	sinɐmomu
cinco	sĩku
cinema	sinemɐ
cinfães	sĩfɐ̃jʃ
cinquenta	sĩkwẽtɐ
cinto	sĩtu
cintura	sĩtuɾɐ
cinturão	sĩtuɾɐ̃w̃
cinza	sĩzɐ
cinzento	sĩzẽtu
cio	siu
cipó	sipɔ
cipozão	sipɔzɐ̃w̃
ciprestal	sipɾɨʃtaɫ
cipreste	sipɾɛʃtɨ
circatejano	siɾkɐtɨʒɐnu
circense	siɹsẽsi
circense	siχsẽsi
circulação	siɾkulɐsɐ̃w̃
circular	siɾkulaɾ
circular	siɾkulaɾ
círculo	siɾkulu
circuncidar	siɾkũⁿsidaɾ
circunferência	siɾkũfɨɾẽsjɐ
cirurgia	siɾuɾʒiɐ
cirurgião	siɾuɾʒjɐ̃w̃
cisco	siʃku
cismar	siʒmaɾ
cisne	siʒnɨ
cisterna	siʃtɛɾnɐ
cisto	siʃtu
citação	sitɐsɐ̃w̃
citadino	sitɐðinu
citar	sitaɾ
cítara	sitɐɾɐ
ciúme	sjumɨ
civil	siviɫ
civilização	sivilizɐsɐ̃w̃
civilização	sɨvɨlizɐsɐ̃w̃
civilizado	sivilizaðu
civilizado	sɨvɨlizaðu
clã	klɐ̃
clandestino	klɐ̃dɨʃtinu
clara	klaɾɐ
clara	klaɾɐ
claramente	klaɾɐmẽtɨ
clarão	klɐɾɐ̃w̃
claridade	klɐɾiðaðɨ
claro	klaɾu
claros	klaɾuʃ
classe	klasɨ
clássico	klasiku
claustro	klawʃtɾu
clausura	klawzuɾɐ
clava	klavɐ
clemente	klɨmẽtɨ
clerical	klɨɾikaɫ
clérigo	klɛɾiɣu
clima	klimɐ
clínica	klinikɐ
clínico	kliniku
clítoris	klitoris
cloroplasto	kloɾoplastu
clorose	kluɾɔzə
clube	kluβɨ
coador	kwɐðoɾ
coar	kuaɾ
coar	kwaɾ
coaxar	kwɐʃaɾ
cobarde	kuβaɾðɨ
coberta	kuβɛɾtɐ
cobertas	kuβɛɾtɐʃ
coberto	kuβɛɾtu
cobertor	kuβɨɾtoɾ
cobiça	kuβisɐ
cobiçar	kubisaɾ
cobra	kɔβɾɐ
cobrar	kuβɾaɾ
cobre	kɔβɾɨ
cobria	kuβɾiɐ
cobrir	kuβɾiɾ
coçar	kusaɾ
coche	kɔʃɨ
cocheira	kuʃɐjɾɐ
cocheira	kuʃejɾɐ
cocheiro	kuʃɐjɾu
cochinchina	kuʃĩʃinɐ
coclear	kukljaɾ
coco	koku
cocô	koko
cocota	kokota
código	kɔðiɣu
cogumelo	kuɣumɛlu
coimbra	kwĩbɾɐ
coiote	kɔjɔtɨ
coisa	kojzɐ
coisas	kojzɐʃ
coitada	kojtaðɐ
coitado	kojtaðu
coitar	kojtaɾ
cola	kɔlɐ
colaboração	kulɐbuɾɐsɐ̃w̃
colante	kulɐ̃tɨ
colar	kulaɾ
colarinho	kulɐɾiɲu
colcha	koɫʃɐ
colchão	koɫʃɐ̃w̃
colchão	kuɫʃɐ̃w̃
coleção	kulɛsɐ̃w̃
colega	kulɛɣɐ
colégio	kulɛʒju
coleira	kulɐjɾɐ
cólera	kɔlɨɾɐ
colesterol	kɔlɨʃtɨɾɔɫ
coleta	kuletɐ
coleta	kulɛtɐ
colete	kuletɨ
colete	kolɛtʃi
coletivamente	kulɛtivɐmẽtɨ
colhão	kuʎɐ̃w̃
colher	kuʎɛɾ
colher	kuʎeɾ
colina	kulinɐ
colmeia	koɫmɐjɐ
colmeia	koɫmejɐ
colmo	koɫmu
colo	kɔlu
colocado	kulukaðu
colónia	kulɔnjɐ
colonização	kulunizɐsɐ̃w̃
colorau	kuluɾaw
colorido	kuluɾiðu
colorir	kuluɾiɾ
coluna	kulunɐ
com	kõ
coma	komɐ
comadre	kumaðɾɨ
comandar	kumɐ̃daɾ
comando	kumɐ̃du
combatente	kõbɐtẽtɨ
combinação	kõbinɐsɐ̃w̃
combinado	kõbinaðu
combinados	kõbinaðu
combinar	kõbinaɾ
comboio	kõbɔju
come	komi
começa	kumɛsɐ
começar	kumɨsaɾ
começava	kumɨsavɐ
começo	kumesu
começo	kumɛsu
começou	kumɨsow
comédia	kumɛðjɐ
comemorar	kumɨmuɾaɾ
comendo	kumẽdu
comer	kumeɾ
comercial	kumɨɾsjaɫ
comercializar	kumɨɾsjalizaɾ
comércio	kumɛɾsju
comete	komɛtʃi
comeu	kumew
comichão	kumiʃãw̃
comida	kumiðɐ
comido	kumiðu
comilão	kumilɐ̃w̃
comissão	kumisɐ̃w̃
comissário	kumisaɾju
comité	kumitɛ
como	komu
comoção	kumusɐ̃w̃
cómoda	kɔmuðɐ
cómodo	kɔmuðu
comover	kumuveɾ
comovido	kumuviðu
compadre	kõpaðɾɨ
compaixão	kõpajʃɐ̃w̃
companha	kõpɐɲɐ
companheiro	kõpɐɲɐjɾu
companheiro	kõpɐ̃j̃ejɾu
companhia	kõpɐɲiɐ
comparação	kõpɐɾɐsɐ̃w̃
comparar	kõpɐɾaɾ
comparativo	kõpɐɾɐtivu
comparável	kõpɐɾavɛɫ
compasso	kõpasu
compatriota	kõpɐtɾjɔtɐ
compêndio	kõpẽdju
competência	kõpɨtẽsjɐ
competia	kõpɨtiɐ
competição	kõpɨtisɐ̃w̃
competidor	kõpɨtiðoɾ
competir	kõpɨtiɾ
compilação	kõpilɐsɐ̃w̃
cômpito	kõpitu
complemento	kõplɨmẽtu
completar	kõplɨtaɾ
compor	kõpoɾ
comportamento	kõpuɾtɐmẽtu
comportar	kõpuɾtaɾ
compota	kõpɔtɐ
comprar	kõpɾaɾ
compreende	kõpɾjẽdɨ
compreender	kõpɾjẽdeɾ
compreensão	kõpɾjẽsɐ̃w̃
comprido	kõpɾiðu
comprimento	kõpɾimẽtu
compromete	kõpɾomɛtʃi
compromisso	kõpɾumisu
computador	kõmputɐðoɾ
computador	kõmptɐðoɾ
computador	k̚m̩ptɐðoɾ
comum	kumũ
comummente	kumũmẽtɨ
comunicação	kumunikɐsɐ̃w̃
comunicado	kumunikaðu
comunicar	kumunikaɾ
comunismo	kɔmuniʒmu
côncavo	kõkɐvu
conceção	kõsɛsɐ̃w̃
conceder	kõsɨðeɾ
conceição	kõsɐjsɐ̃w̃
conceição	kõsejsɐ̃w̃
conceição	kõsɐjsɐ̃w̃
conceição	kõsejsɐ̃w̃
conceito	kõsɐjtu
conceito	kõsejtu
concelho	kõseʎu
concelho	kõsejʎu
concelho	kõsɐʎu
concelho	kõsɐjʎu
concha	kõʃɐ
conciliar	kõsiljaɾ
concitador	kõsitɐðoɾ
conclusão	kõkluzɐ̃w̃
concordar	kõkuɾðaɾ
concretizar	kõkɾɨtizaɾ
concreto	kõkɾɛtu
condão	kõdɐ̃w̃
conde	kõdɨ
condensação	kõdẽsɐsɐ̃w̃
condição	kõdisɐ̃w̃
condizer	kõdizeɾ
condução	kõdusɐ̃w̃
conduta	kõdutɐ
condutor	kõdutoɾ
conduzir	kõduziɾ
conectar	kunɛktaɾ
conexão	kunɛksɐ̃w̃
conexo	konɛksu
confeção	kõfɛsɐ̃w̃
confederação	kõfɨðɨɾɐsɐ̃w̃
confeição	kõfɐjsɐ̃w̃
confeição	kõfejsɐ̃w̃
confessar	kõfɨsaɾ
confete	kõfɛtʃi
confiança	kõfjɐ̃sɐ
confiar	kõfiaɾ
confiar	kõfjaɾ
confidência	kõfiðẽsjɐ
confissão	kõfisɐ̃w̃
confortar	kõfuɾtaɾ
confortável	kõfuɾtavɛɫ
conforto	kõfoɾtu
conforto	kõfɔɾtu
confrontar	kõfrõtaɾ
confusão	kõfuzɐ̃w̃
confuso	kõfuzu
congelar	kõʒɨlaɾ
congénere	kõʒɛnɨɾɨ
congratulou	kõɡɾatulow
congregação	kõɡɾɨɣɐsɐ̃w̃
congresso	kõɡɾɛsu
conhaque	kɔɲakɨ
conhece	kuɲɛsɨ
conhecedor	kuɲɨsɨðoɾ
conhecer	kuɲɨseɾ
conhecera	kuɲɨseɾɐ
conhecerá	kuɲɨsɨɾa
conhecia	kuɲɨsiɐ
conhecida	kuɲɨsiðɐ
conhecido	kuɲɨsiðu
conhecimento	kuɲɨsimẽtu
conheço	kuɲesu
conivência	konivẽɲ̞sjɐ
conjunto	kõʒũtu
connosco	kõnoʃku
conquista	kõkiʃtɐ
conquistar	kõkiʃtaɾ
conquistas	kõkiʃtɐʃ
consagrar	kõsɐɣɾaɾ
consciência	kõʃsjẽsjɐ
consciente	kõʃsjẽtɨ
conseguinte	kõseɡĩti
conseguir	kõsɨɣiɾ
conselheiro	kõsɨʎɐjɾu
conselho	kõseʎu
conselho	kõsɐjʎu
consentimento	kõsẽtimẽtu
consentir	kõsẽtiɾ
consequência	kõsɨkwẽsjɐ
consertar	kõsɨɾtaɾ
conservava	kõsɨɾvavɐ
consideração	kõsiðɨɾɐsɐ̃w̃
considerar	kõsiðɨɾaɾ
consideravelmente	kʊ̃sɪdəɾavɛlmɛ̃t
consigo	kõsiɣu
consigo	kũsiɣu
consoada	kõswaðɐ
consoante	kõswɐ̃tɨ
consolação	kõsulɐsɐ̃w̃
consolar	kõsulaɾ
consolo	kõsolu
consolo	kõsɔlu
constança	kõʃtɐ̃sɐ
constância	kõʃtɐ̃sjɐ
constância	kõʃtɐ̃sjɐ
constante	kõʃtɐ̃tɨ
constantemente	kõʃtɐ̃tɨmẽtɨ
constatação	kõʃtɐtɐsɐ̃w̃
constipação	kõʃtipɐsɐ̃w̃
constituir	kõʃtitwiɾ
constrangimento	kõstrɐ̃ʒimẽtu
construção	kõʃtɾusɐ̃w̃
construir	kõʃtɾuiɾ
construtor	kõʃtɾutoɾ
cônsul	kõsuɫ
consulado	kõsulaðu
consular	kõsulaɾ
consultório	kõsuɫtɔɾju
consumir	kõsumiɾ
consumo	kõsumu
conta	kõtɐ
contactar	kõtɐktaɾ
contacto	kõtaktu
contanto	kõtɐ̃tu
contar	kõtaɾ
contas	kõtɐʃ
contato	kõtatu
contentar	kõtẽtaɾ
contente	kõtẽtɨ
contentor	kõtẽtoɾ
conter	kõteɾ
conteúdo	kõtjuðu
contigo	kõtiɣu
continente	kõtinẽtɨ
contingenciamento	kõtĩʒẽsjamẽtu
contino	kõtinu
continua	kõtinuɐ
continuamente	kõtinwɐmẽtɨ
continuar	kõtinwaɾ
continuava	kõtinwavɐ
contínuo	kõtinwu
continuou	kõtinwow
conto	kõtu
contornar	kõtuɾnaɾ
contorno	kõtoɾnu
contos	kõtuʃ
contou	kõtow
contrabaixo	kõtrɐbajʃu
contraceção	kõtɾɐsɛsɐ̃w̃
contracetivo	kõtɾɐsɛtivu
contramão	kõwtɾamãw
contramestre	kõtɾɐmɛʃtɾɨ
contrariar	kõtɾɐɾjaɾ
contrário	kõtɾaɾju
contratar	kõtɾɐtaɾ
contribuição	kõtɾiβwisɐ̃w̃
controlador	kõtɾulɐdoɾ
controlo	kõtɾolu
controlo	kõtɾɔlu
contudo	kõtuðu
convenção	kõvẽsɐ̃w̃
convencer	kõvẽseɾ
convento	kõvẽtu
conversa	kõvɛɾsɐ
conversando	kõvɨɾsɐ̃du
conversar	kõvɨɾsaɾ
convés	kõvɛʃ
convexo	kõvɛksu
convicção	kõviksɐ̃w̃
convidar	kõviðaɾ
convosco	kõvoʃku
cooptar	kooptaɾ
cooptar	kooptaʁ
coorte	kuɔɾtɨ
coorte	kwɔɾtɨ
copa	kɔpɐ
cópia	kɔpjɐ
copiar	kupjaɾ
copla	kɔplɐ
copo	kɔpu
coquete	kokɛtʃi
cor	koɾ
cor	kɔɾ
coração	kuɾɐsɐ̃w̃
coração	kɔɾɐsɐ̃w̃
corações	kuɾɐsõj̃ʃ
coragem	kuɾaʒɐ̃j̃
corajoso	kuɾɐʒozu
corar	kɔɾaɾ
corça	kɔɾsɐ
corda	kɔɾdɐ
cordão	kuɾðɐ̃w̃
cordas	kɔɾdɐʃ
cordilheira	kuɾðiʎɐjɾɐ
cordões	kuɾðõj̃ʃ
cores	koɾɨʃ
corintiano	koɾĩtʃiɐ̃nu
corno	koɾnu
coro	koɾu
coró	koɾɔ
coroa	kuɾoɐ
coronariano	koɾonaɾiãnu
coros	kɔɾuʃ
corpo	koɾpu
corporal	kuɾpuɾaɫ
corpos	kɔɾpuʃ
corredor	kuʁɨðoɾ
correia	kuʁɐjɐ
correia	kuʁejɐ
correio	kuʁɐju
correndo	kuʁẽdu
corrente	kuʁẽtɨ
correr	kuʁeɾ
correspondência	kuʁɨʃpõdẽsjɐ
corresponder	kuʁɨʃpõdeɾ
corretamente	kuʁɛtɐmẽtɨ
correto	kuʁɛtu
correu	kuʁew
corria	kuʁiɐ
corrida	kuʁiðɐ
corrimão	kuʁimɐ̃w̃
corroboração	kuʁuβuɾɐsɐ̃w̃
corrupção	kuʁupsɐ̃w̃
corrupto	kuʁuptu
córsico	kɔɾsiku
corso	koɾsu̥
cortado	kuɾtaðu
cortando	kuɾtɐ̃du
cortar	kuɾtaɾ
corte	kɔɾtɨ
corte	koɾtɨ
cortiça	kuɾtisɐ
cortina	kuɾtinɐ
coruche	kuɾuʃɨ
coruja	kuɾuʒɐ
corvo	koɾvu
corvo	koɾvu
coser	kuzer
cosseno	kusenu
costa	kɔʃtɐ
costa	kɔʃtɐ
costas	kɔʃtɐʃ
costumar	kuʃtumaɾ
costumava	kuʃtumavɐ
costume	kuʃtumɨ
cota	kɔta
cotangente	kotɐ̃ʒẽtɨ
cotonete	kotonɛtʃi
cotovelo	kutuvelu
cotovelos	kʊtʊvɛluʃ
cotovia	kutuviɐ
couraçado	kowɾɐsaðu
couro	kowɾu
cousa	kowzɐ
couve	kowvɨ
cova	kɔvɐ
côvão	kovɐ̃w̃
coveiro	kuvɐjɾu
coveiro	kuvejɾu
coveiro	kɔvɐjɾu
coveiro	kɔvejɾu
covilhã	kuviʎɐ̃
covo	kovu
coxa	koʃɐ
cozer	kuzeɾ
cozinha	kuziɲɐ
cozinhar	kuziɲaɾ
cozinheiro	kuziɲɐjɾu
crânio	kɾɐnju
crás	kɾaʃ
crasso	kɾasu
crato	kɾatu
cravejado	kɾɐvɨʒaðu
cravo	kɾavu
creditar	kɾɨðitaɾ
crédito	kɾɛðitu
credo	kɾɛðu
credor	kɾɛðoɾ
credulidade	kɾɛðuliðaðɨ
creio	kɾɐju
crença	kɾẽsɐ
crente	kɾẽtɨ
crepe	kɾɛpe
crepe	kɾɛpi
crepes	kɾɛpes
crepes	kɾɛpis
crepes	kɾɛpiʃ
crepúsculo	kɾɨpuʃkulu
crer	kɾeɾ
crescendo	kɾɨʃsẽdu
crescer	kɾɨʃseɾ
crescido	kɾɨʃsiðu
crescimento	kɾɨʃsimẽtu
cretino	kɾet͡inu
creu	kɾew
criação	kɾiəsə̃ʊ
criações	kɾiəsʊ̃ɪʃ
criada	kɾjaðɐ
criados	kɾiaðuʃ
criança	kɾiɐ̃sɐ
crianças	kɾiɐ̃sɐʃ
criar	kɾiaɾ
criatura	kɾiɐtuɾɐ
crica	kɾika
cricri	kɾikɾi
crime	kɾimɨ
criminal	kɾiminaɫ
criminoso	kɾiminozu
crioulo	kɾjowlu
criptídeo	kɾiptʃidʒiu
criptido	kɾiptʃido
criptoanálise	kɾiptoanalizi
criptoanalista	kɾiptoanalista
criptoanalista	kɾiptoanalijʃta
criptobiose	kɾiptobiɔzi
criptobiótico	kɾiptobiɔtʃiku
criptococose	kɾiptokokɔzi
criptocomunismo	kɾipkomunismu
criptocomunismo	kɾipkomunijʃmu
criptocomunista	kɾipkomunista
criptocomunista	kɾipkomunijʃta
criptofascismo	kɾiptofasismu
criptofascismo	kɾiptofasijʃmu
criptofascista	kɾiptofasista
criptofascista	kɾiptofasijʃta
criptofone	kɾiptofoni
criptoftalmia	kɾiptoftaɫmia
criptoftalmia	kɾiptoftawmia
criptoftalmo	kɾiptoftaɫmu
criptógama	kɾiptɔɡɐma
criptogâmico	kɾipɡɐmiku
criptografia	kɾiptoɡɾafia
criptógrafo	kɾiptɔɡɾafu
criptograma	kɾiptoɡɾɐma
criptologia	kɾiptoloʒia
criptológico	kɾiptolɔʒiku
criptomnésia	kɾiptomnɛzja
criptomnésico	kɾiptomnɛziku
criptomoeda	kɾiptomuɛda
criptônimo	kɾiptonimu
criptorquia	kɾiptoɾkia
criptorquia	kɾiptoʁkia
criptoscopia	kɾiptoskopia
criptoscopia	kɾiptoʃkopia
criptósporo	kɾiptɔspoɾu
criptósporo	kɾiptɔʃpoɾu
criptossistema	kɾipsistema
criptossistema	kɾipsijʃtema
criptoxantina	kɾiptoʃãtʃina
criptozoologia	kɾiptozooloʒia
criptozoólogo	kɾiptozoɔloɡu
crise	kɾizɨ
crisol	kɾizɔɫ
crista	kɾiʃtɐ
cristal	kɾiʃtaɫ
cristão	kɾiʃtɐ̃w̃
cristiano	kɾiʃtjɐnu
cristo	kɾiʃtu
criticar	kɾitikaɾ
crítico	kɾitiku
croácia	kɾuasjɐ
cronómetro	kɾunɔmɨtɾu
croquete	kɾokɛtʃi
cru	kɾu
cruel	kɾuɛɫ
crueldade	kɾuɛɫdaðɨ
cruz	kɾuʃ
cruzada	kɾuzadɐ
cruzado	kɾuzaðu
cruzados	kɾuzaðuʃ
cruzeta	kɾuzetɐ
cu	ku
cuba	kuβɐ
cuba	kuβɐ
cubicar	kuβikaɾ
cubículo	kuβikulu
cuca	kuka
cuca	kukɐ
cuecas	kwɛkɐʃ
cueiro	kwɐjɾu
cueiro	kwejɾu
cuiabá	kujaba
cuidado	kujðaðu
cuidado	kwiðaðu
cuja	kuʒɐ
cujo	kuʒu
cujos	kuʒuʃ
culpa	kuɫpɐ
culposamente	kuɫpozɐmẽtɨ
cultura	kuɫtuɾɐ
cultural	kuɫtuɾaɫ
cúmplice	kũplisɨ
cumprimento	kũpɾimẽtu
cúmulo	kumulu
cuneta	kuneta
cunha	kuɲɐ
cunhada	kuɲaðɐ
cunhado	kuɲaðu
cupido	kupiðu
cupom	kupõ
cúpula	kupulɐ
cuque	kukə
curação	kuɾɐsɐ̃w̃
curcuma	kuɾkumɐ
cúrcuma	kuɾkumɐ
curinga	kuɾĩɡɐ
curiosidade	kuɾjuziðaðɨ
curiosidades	kʊɾjʊzidatəʃ
curioso	kuɾjozu
curitiba	kuɾitibɐ
curral	kuʁaɫ
currículo	kuʁikulu
curta	kuɾtɐ
curtir	kuɾtiɾ
curto	kuɾtu
curtume	kuɾtumɨ
curva	kuɾvɐ
curvar	kuɾvaɾ
cuspir	kuʃpiɾ
custa	kuʃtɐ
custar	kuʃtaɾ
custo	kuʃtu
custódia	kuʃtɔðjɐ
cutelo	kutɛlu
cuzão	kuzɐ̃w̃
czar	tsaɾ
da	dɐ
dá	da
dádiva	daðivɐ
dado	daðu
dai	daj
daí	dɐi
dali	dɐli
dalmática	dalmatikɐ
dama	dɐmɐ
damas	dɐmɐʃ
damasco	dɐmaʃku
danado	dɐnaðu
danbo	dɐ̃bu
dança	dɐ̃sɐ
dançarino	dɐ̃sɐɾinu
danço	dɐ̃su
dando	dɐ̃du
dano	dɐnu
danoso	dɐnozu
danúbio	dɐnuβju
dão	dɐ̃w̃
dão	dɐ̃w̃
daquela	dɐkɛlɐ
daquelas	dɐkɛlɐʃ
daquele	dɐkelɨ
daqueles	dɐkelɨʃ
daqui	daki
daqui	dɐki
daqui	dɐki
daquilo	dɐkilu
dar	daɾ
das	dɐʃ
data	datɐ
datilógrafo	dɐktilɔɣɾɐfu
datiloscopia	dɐktilɔʃkupiɐ
dava	davɐ
davam	davɐ̃w̃
de	dɨ
dê	de
debelar	debelaɾ
debelar	debelaχ
debilidade	dɨβiliðaðɨ
debilidade	dɨβɨliðaðɨ
debruçou	debɾusow
debuxar	dɨβuʃaɾ
década	dɛkɐðɐ
decágono	dɨkaɡunu
decente	dɨsẽtɨ
decerto	dɨsɛɾtu
decidido	dɨsiðiðu
decidido	dɨsɨðiðu
decidir	dɨsiðiɾ
decidir	dɨsɨðiɾ
decidira	dɨsiðiɾɐ
decidirá	dɨsiðiɾa
décimo	dɛsimu
decisão	dɨsizɐ̃w̃
decisivo	dɨsizivu
declaração	dɨklɐɾɐsɐ̃w̃
declarar	dɨklɐɾaɾ
declarou	dɨklɐɾow
declive	dɨklivɨ
decompor	dɨkõpoɾ
decoração	dɨkuɾɐsɐ̃w̃
decorador	dɨkuɾɐðoɾ
decorar	dɨkuɾaɾ
decurso	dəkursu
dedal	dɨðaɫ
dedetização	dedetʃizasɐ̃w̃
dedo	deðu
dedos	deðuʃ
deduzir	dɨðuziɾ
deem	deɐ̃j
dêem	deɐ̃j
defeito	dɨfɐjtu
defeito	dɨfejtu
defender	dɨfẽdeɾ
defesa	dɨfezɐ
defeso	dɨfezu
déficit	dɛfisitʃi
deficitário	defisitarju
definitivamente	dɨfinitivɐmẽtɨ
definitivo	dɨfinitivu
definitivo	dɨfɨnitivu
deflagração	deflaɡɾasɐ̃w̃
deflagrar	deflaɡɾaɾ
deflagrar	deflaɡɾaχ
deformação	dɨfuɾmɐsɐ̃w̃
defronte	dɨfɾõtɨ
degrau	dɨɣɾaw
degraus	dɨɣɾɐwʃ
deificação	deifikɐsɐ̃w̃
deitado	dɐjtaðu
deitar	dɐjtaɾ
deixa	dɐjʃɐ
deixado	dɐjʃaðu
deixara	dɐjʃaɾɐ
deixará	dɐjʃɐɾa
deixava	dɐjʃavɐ
deixou	dɐjʃow
dela	dɛlɐ
dele	delɨ
delegar	dɨlɨɣaɾ
delete	dlɛtʃi
delgado	dɛɫɣaðu
delicado	dɨlikaðu
deliciosa	dɨlisjɔzɐ
deliciosamente	dɨlisjɔzɐmẽtɨ
delicioso	dɨlisjozu
delírio	dɨliɾju
delito	dɨlitu
delta	dɛɫtɐ
demais	dɨmajʃ
demasiado	dɨmɐziaðu
demasiado	dɨmɐzjaðu
demissexual	demiseksuaɫ
demo	demu
democracia	dɨmukɾɐsiɐ
demográfico	dɨmuɣɾafiku
demónio	dɨmɔnju
demonstrar	dɨmõʃtɾaɾ
demora	dɨmɔɾɐ
demorar	dɨmuɾaɾ
dendê	dẽde
denso	dẽsu
dental	dẽtaɫ
dentário	dẽtaɾju
dente	dẽtɨ
dentes	dẽtɨʃ
dentífrico	dẽtifɾiku
dentista	dẽtiʃtɐ
dentro	dẽtɾu
dependência	dɨpẽdẽsjɐ
depender	dɨpẽdeɾ
depois	dɨpojʃ
deprê	depɾe
deprecar	depɾekaɾ
deprecar	depɾekaχ
depreciativo	depɾesjatʃivu
depressa	dɨpɾɛsɐ
deputado	dɨputaðu
deque	dɛki
dera	dɛɾɐ
derradeiro	dɨʁɐðɐjɾu
derramamento	dɨʁɐmɐmẽtu
derramar	dɨʁɐmaɾ
derrame	dɨʁamɨ
derrete	deʁɛtʃi
derrocar	dɨʁukaɾ
desafiar	dɨzɐfjaɾ
desafinar	dəzɐfinaɾ
desafio	dɨzɐfiu
desaforamento	dʒizafoɾamẽtu
desaforamento	dezafoɾamẽtu
desaforar	dʒizafoɾaɾ
desaforar	dʒizafoɾaχ
desaforo	dʒizafoɾu
desaforo	dezafoɾu
desaforo	dʒizafɔɾu
desaforo	dezafɔɾu
desambiguação	dzɨmbiɡwəsə̃ʊ
desaparecer	dɨzɐpɐɾɨseɾ
desaparecido	dɨzɐpɐɾɨsiðu
desaparecimento	dɨzɐpɐɾɨsimẽtu
desapercebido	dʒizapeɾsebidu
desapercebido	dezapeɾsebidu
desarmamentista	dʒizaɾmamẽtʃista
desarmamentista	dezaʁmamẽtʃijʃta
desarrazoar	dɨzɐʁɐzwaɾ
desarticular	dezartʃikular
desasar	dɨzazaɾ
desassossego	dəzɐsuseɡu
desastre	dɨzaʃtɾɨ
desatar	dɨzɐtaɾ
desatarraxar	dɨzɐtɐʁɐʃaɾ
descalçar	dɨʃkaɫsaɾ
descalço	dɨʃkaɫsu
descansar	dɨʃkɐ̃saɾ
descanso	dɨʃkɐ̃su
descarregar	dɨʃkɐʁɨɣaɾ
desce	dɛʃsɨ
descendo	dɨʃsẽdu
descer	dɨʃseɾ
desceu	dɨʃsew
descia	dɨʃsiɐ
descida	dɨʃsiðɐ
descido	dɨʃsiðu
descoberta	dɨʃkuβɛɾtɐ
descoberto	dɨʃkuβɛɾtu
descobridor	dɨʃkuβɾiðoɾ
descobrimento	dɨʃkuβɾimẽtu
descobrir	dɨʃkuβɾiɾ
desconexo	dʒijʃkonɛksu
desconfiado	dɨʃkõfjaðu
desconhecer	dɨʃkuɲɨseɾ
desconhecido	dɨʃkuɲɨsiðu
desconhecimento	dɨʃkuɲɨsimẽtu
desconsideração	dɨʃkõsiðɨɾɐsɐ̃w̃
desconsolado	dɨʃkõsulaðu
descrição	dɨʃkɾisɐ̃w̃
desculpa	dɨʃkuɫpɐ
desde	deʒðɨ
desdém	dɨʒðɐ̃j̃
desdenhar	dɨʒðɐɲaɾ
desdenhoso	dɨʒðɐɲozu
desdo	deʒðu
deseducado	dʒizedukadu
desejar	dɨzɨʒaɾ
desejo	dɨzɐjʒu
desejo	dɨzeʒu
desejoso	dɨzɨʒozu
desencadear	dɨzẽkɐðjaɾ
desenhar	dɨzɨɲaɾ
desenho	dɨzeɲu
desenho	dɨzɐɲu
desenho	dɨzɐjɲu
desenrascanço	dɨzɐ̃j̃ʁɐʃkɐ̃sʊ
desentendimento	dezẽtẽdʒimẽtu
desenvencilhar	desẽvẽsiʎaɾ
desenvencilhar	desẽvẽsiʎaχ
desenvincilhar	desẽvĩsiʎaɾ
desenvincilhar	desẽvĩsiʎaχ
desenvolver	dɨzẽvoɫveɾ
desenvolvimento	dɨzẽvoɫvimẽtu
desequilibrou	dezekilibɾow
desequilibrou	d͡ʒi-
desertificar	dɨzɨɾtifikaɾ
deserto	dɨzɛɾtu
desesperadamente	dɨzɨʃpɨɾaðɐmẽtɨ
desfazer	dɨʃfɐzeɾ
desfazimento	desfazimẽtu
desfazimento	dʒisfazimẽtu
desfecho	dəʃfɐjʃu
desfecho	dəʃfeʃu
desferir	dɨʃfɨɾiɾ
desgostar	dɨʒɣuʃtaɾ
desgosto	dɨʒɣoʃtu
desgraça	dɨʒɣɾasɐ
desgraçado	dɨʒɣɾɐsaðu
desídia	dezidʒja
desidratação	dɨzidɾɐtɐsɐ̃w̃
designadamente	dɨziɣnaðɐmẽtɨ
designado	dɨziɣnaðu
desígnio	deziɡnju
desilusão	dɨziluzɐ̃w̃
desinteresse	dɨzĩtɨɾesɨ
desjejum	dɨʒɨʒũ
desleixar	dɨʒlɐjʃar
desligado	dɨʒliɣaðu
desligar	dɨʒliɣaɾ
deslindar	dɨʒlĩdaɾ
deslizar	dɨʒlizaɾ
desmaiar	dɨʒmajaɾ
desmaio	dɨʒmaju
desmanchar	dɨʒmɐ̃ʃaɾ
desolação	dezolasɐ̃w̃
desolado	dɨzulaðu
desolar	dezolaɾ
desolar	dezolaχ
desonerar	dɨzunɨɾaɾ
desonroso	dɨzõʁozu
desordem	dɨzɔɾðɐ̃j̃
desorganização	dɨzɔɾɣɐnizɐsɐ̃w̃
desorganizado	dɨzɔɾɣɐnizaðu
desorganizar	dɨzɔɾɣɐnizaɾ
despassarado	dɨʃpɐsɐɾaðu
despedido	dɨʃpɨðiðu
despedir	dɨʃpɨðiɾ
despeito	dɨʃpɐjtu
despender	dɨʃpẽdeɾ
despenhadeiro	dɨʃpɐɲɐðɐjɾu
despensa	dɨʃpẽsɐ
desperdiçar	dɨʃpɨɾðisaɾ
desperdício	dɨʃpɨɾðisju
despertador	dɨʃpɨɾtɐðoɾ
despertar	dɨʃpɨɾtaɾ
desperto	dɨʃpɛɾtu
despesa	dɨʃpezɐ
despesas	dɨʃpezɐʃ
despir	dɨʃpiɾ
desportivo	dɨʃpuɾtivu
desporto	dɨʃpoɾtu
desqualificar	dɨʃkwɐlifikaɾ
dessa	dɛsɐ
dessas	dɛsɐʃ
desse	desɨ
desses	desɨʃ
desta	dɛʃtɐ
destacamento	dɨʃtakɐmẽtu
destacar	dɨʃtɐkaɾ
destacareis	dɘʃtɐkɐɾɐjʃ
destas	dɛʃtɐʃ
deste	deʃtɨ
deste	dɛʃtɨ
desterrar	dɨʃtɨʁaɾ
desterro	dɨʃteʁu
destes	deʃtɨʃ
destes	dɛʃtɨʃ
destino	dɨʃtinu
destra	dɛʃtɾɐ
destras	dɛʃtɾɐʃ
destreza	dɨʃtɾezɐ
destro	dɛʃtɾu
destruição	dɨʃtɾuisɐ̃w̃
destruído	dɨʃtɾuiðu
destruidor	dɨʃtɾuiðoɾ
destruir	dɨʃtɾuiɾ
destrutivo	dɨʃtɾutivu
desvencilhar	desvẽsiʎaɾ
desvencilhar	desvẽsiʎaχ
desviar	dɨʒvjaɾ
detalhe	dɨtaʎɨ
detalhes	dɨtaʎɨʃ
deterioração	dɨtɨɾjuɾɐsɐ̃w̃
deteriorar	dɨtɨɾjuɾaɾ
determinação	dɨtɨɾminɐsɐ̃w̃
detetar	dətɛtar
deturpação	detuɾpasɐ̃w̃
deturpação	detuʁpasɐ̃w̃
deu	dew
deus	dewʃ
deus	dewʃ
deusa	dewzɐ
deuses	dewzɨʃ
devagar	dɨvɐɣaɾ
devagarinho	dɨvɐɣɐɾiɲu
devassa	dɨvasɐ
devasso	dɨvasu
deve	dɛvɨ
devedor	dɨvɨðoɾ
dever	dɨveɾ
deveres	dɨveɾɨʃ
deveria	dɨvɨɾiɐ
devesa	dɨvezɐ
devia	dɨviɐ
devoção	dɨvusɐ̃w̃
devorar	dɨvuɾaɾ
dez	dɛʃ
dezanove	dɨzɐnɔvɨ
dezasseis	dɨzɐsɐjʃ
dezassete	dɨzɐsɛtɨ
dezembro	dɨzẽbɾu
dezoito	dɨzojtu
dezoito	dɨzɔjtu
dia	diɐ
diabete	dʒiabɛtʃi
diabo	diaβu
diabo	djaβu
diabo	diaβu
diabo	djaβu
diacho	djaʃu
dialeto	djɐlɛtu
diamante	djɐmɐ̃tɨ
diante	djɐ̃tɨ
diariamente	dʒiariamentʃi
diário	djaɾju
dias	diɐʃ
diáspora	djaʃpuɾɐ
dica	dikɐ
dicionário	disjunaɾju
diferença	difɨɾẽsɐ
diferente	difɨɾẽtɨ
diferentes	difɨɾẽtɨʃ
diferir	difɨɾiɾ
difícil	difisiɫ
difícil	dɨfisiɫ
dificuldade	difikuɫðaðɨ
difuso	difuzu
diga	diɣɐ
digestão	diʒɨʃtɐ̃w̃
digital	diʒitaɫ
dígito	diʒitu
dignidade	diɡniðaðɨ
dignificar	diɣɨnifikaɾ
digno	diɡnu
digo	diɡu
dildo	dildu
dilúvio	diluvju
diminuição	diminuisɐ̃w̃
diminuir	diminwiɾ
diminuir	dɨminwiɾ
dinamarca	dinɐmaɾkɐ
dinastia	dinɐʃtiɐ
dinheiro	diɲɐjɾu
dino	dinu
dinossauro	dinɔsawɾu
diospireiro	djɔʃpiɾɐjɾu
dióspiro	djɔʃpiɾu
diplomata	diplumatɐ
diplomático	diplumatiku
díptico	diptiku
direção	diɾɛsɐ̃w̃
direita	diɾɐjtɐ
direito	diɾɐjtu
direitos	diɾɐjtuʃ
diretiva	diɾɛtivɐ
direto	diɾɛtu
diretor	diɾɛtoɾ
dirigir	diɾiʒiɾ
dirigível	diɾiʒivɛɫ
dirigível	dɨɾiʒivɛɫ
discente	disẽtʃi
disciplina	diʃsiplinɐ
discrição	diʃkɾisə̃ʊ
discrições	diʃkɾisʊ̃ɪʃ
discurso	dɨʃkuɾsu
discussão	diʃkusɐ̃w̃
discutir	diʃkutiɾ
disjunção	diʒũsɐ̃ũ
disponibilidade	diʃpuniβiliðaðɨ
disponibilizar	diʃpuniβilizaɾ
disponível	diʃpunivɛɫ
dispor	diʃpoɾ
disposição	diʃpuzisɐ̃w̃
disposto	diʃpoʃtu
disputar	diʃputaɾ
disse	disɨ
dissera	disɛɾɐ
dissertação	disɨɾtɐsɐ̃w̃
dissesse	disɛsɨ
dissipar	disipaɾ
disso	disu
dissociável	dʒisosiavew
dissonância	dʒisonɐ̃sja
distância	diʃtɐ̃sjɐ
distante	diʃtɐ̃tɨ
distinção	diʃtĩsɐ̃w̃
distinguiam	diʃtĩɡiɐ̃w̃
distinguir	diʃtĩɡiɾ
distinto	diʃtĩtu
disto	diʃtu
distorção	dɨʃtuɾsɐ̃w̃
distração	dɨʃtɾasɐ̃w̃
distraído	diʃtɾɐiðu
distrair	diʃtɾɐiɾ
distribuição	diʃtɾiβwisɐ̃w̃
distribuição	dɨʃtɾiβwisɐ̃w̃
distribuidor	diʃtɾiβwiðoɾ
distribuidor	dɨʃtɾiβwiðoɾ
distribuir	diʃtɾiβwiɾ
distribuir	dɨʃtɾiβwiɾ
distribuir	diʃtɾiβuiɾ
distribuir	dɨʃtɾiβuiɾ
distúrbio	dɨʃtuɾβju
ditado	ditaðu
ditador	ditɐðoɾ
ditadura	ditɐðuɾɐ
ditar	ditaɾ
dito	ditu
divã	divɐ̃
divãs	divɐ̃ʃ
diversão	divɨɾsɐ̃w̃
divertido	divɨɾtiðu
divertimento	divɨɾtimẽtu
divertir	divɨrtir
dívida	dividɐ
dividir	dividiɾ
dividir	dɨvidiɾ
divina	divinɐ
divindade	divĩdaðɨ
divino	divinu
divisão	divizɐ̃w̃
divulgação	divuɫɣɐsɐ̃w̃
divulgar	divuɫɣaɾ
diz	diʃ
dizem	dizɐ̃j̃
dizendo	dizẽdu
dizer	dizeɾ
dizia	diziɐ
do	du
dó	dɔ
doação	duɐsɐ̃w̃
doar	duaɾ
dobra	dɔβɾɐ
dobradiça	dubrɐdisɐ
dobrar	duβɾaɾ
dobras	dɔβɾɐʃ
dobro	doβɾu
dobro	dɔβɾu
doca	dɔkɐ
doçaria	dusɐɾiɐ
doce	dosɨ
doceiro	dusɐjɾu
docemente	dosɨmẽtɨ
docente	dusẽtɨ
dócil	dɔsiɫ
documental	dukumẽtaɫ
documento	dukumẽtu
doçura	dusuɾɐ
dodecaedro	duðɨkɐɛðɾu
dodó	dɔðɔ
doença	dwẽsɐ
doente	dwẽtɨ
doentio	dwẽtiu
doer	dueɾ
doer	dweɾ
doido	dojdu
dois	dojʃ
dólar	dɔlaɾ
doloroso	duluɾozu
dom	dõ
doméstica	dumɛʃtikɐ
doméstico	dumɛʃtiku
dominatrix	dominatriks
dominatrixes	dominatriksis
domingo	dumĩɡu
domingueiro	dumĩɡɐjɾu
dominó	dɔminɔ
dona	donɐ
donaire	dunajɾɨ
donatário	dunɐtaɾju
donbass	dõbas
donde	dõdɨ
doninha	dɔniɲɐ
dono	donu
donos	donuʃ
donzela	dõzɛlɐ
dores	doɾɨʃ
dorido	duɾiðu
dormente	duɾmẽtɨ
dormia	duɾmiɐ
dormindo	duɾmĩdu
dorminhoco	duɾmiɲoku
dormir	duɾmiɾ
dormitar	duɾmitaɾ
dorso	doɾsu
dos	duʃ
dossel	dusɛɫ
dossiê	dɔsje
dosso	dosu
doudo	dowdu
dourado	dowɾaðu
dourar	dowɾaɾ
douro	dowɾu
doutor	dowtoɾ
doutrina	dowtɾinɐ
doutrinação	dowtɾinɐsɐ̃w̃
doutro	dowtɾu
doze	dozɨ
drácula	dɾakulɐ
dragão	dɾɐɣɐ̃w̃
droga	dɾɔɣɐ
drogaria	dɾuɣɐɾiɐ
duas	duɐʃ
duende	duẽdɨ
duende	dwẽdɨ
dum	dũ
duma	dumɐ
dumas	dumɐʃ
duns	dũʃ
dupla	duplɐ
duque	dukɨ
duradouro	duɾɐðowɾu
durante	duɾɐ̃tɨ
durar	duɾaɾ
dureza	duɾezɐ
duro	duɾu
duunvirato	duũviɾatu
dúvida	duviðɐ
duvidar	duviðaɾ
duvidoso	duviðozu
duzentos	duzẽtuʃ
dúzia	duzjɐ
e	ɛ
e	e
e	i
é	ɛ
ebó	ebɔ
eclesiástico	iklɨzjaʃtiku
eco	ɛku
economia	ikɔnumiɐ
económico	ikunɔmiku
economista	ikunumiʃtɐ
ecrã	ɛkɾɐ̃
eczema	iɡzɛmɐ
edificação	iðifikɐsɐ̃w̃
edificar	iðifikaɾ
edifício	iðifisju
edimburgo	ɛðĩbuɾɣu
edito	editu
editor	iðitoɾ
editorial	iðituɾjaɫ
edredom	edɾedõ
educação	iðukɐsɐ̃w̃
educado	iðukaðu
educar	iðukaɾ
efe	ɛfɨ
efeito	ifɐjtu
efetivo	efetʃivu
efetuar	ifɛtuaɾ
efetuar	ifɛtwaɾ
egito	iʒitu
ego	ɛɣu
egoísmo	iɣwiʒmu
egoísta	iɣwiʃtɐ
égua	ɛɣwɐ
ei	ej
eira	ɐjɾɐ
eis	ɐjʃ
eis	ejʃ
eixo	ɐjʃu
eixo	ejʃu
ejete	eʒɛtʃi
ela	ɛlɐ
elas	ɛlɐʃ
elasticidade	ilɐʃtisiðaðɨ
elasticidade	ilɐʃtɨsiðaðɨ
elástico	ilaʃtiku
ele	elɨ
ele	ɛlɨ
elefante	ilɨfɐ̃tɨ
elegante	ilɨɣɐ̃tɨ
elegantemente	ilɨɣɐ̃tɨmẽtɨ
elemento	ilɨmẽtu
eles	elɨʃ
eletrão	ilɛtɾɐ̃w̃
eletricidade	ilɛtɾisiðaðɨ
elétrico	ilɛtɾiku
elevação	ilɨvɐsɐ̃w̃
elevado	ilɨvaðu
elevador	ilɨvɐðoɾ
elevar	ilɨvaɾ
eliminação	ilɨminɐsɐ̃w̃
elmo	ɛɫmu
elo	ɛlu
eloá	eloa
eloquência	ilukwẽsjɐ
eloquência	elukwẽsjɐ
elucubração	elukubɾasɐ̃w̃
elucubrar	elukubraɾ
em	ɐ̃j̃
emascular	imɐskulaɾ
embaixada	ẽbajʃaðɐ
embaixada	ĩ-
embaixador	ẽbajʃɐðoɾ
embaraço	ẽbɐɾasu
embarcação	ẽbɐɾkɐsɐ̃w̃
embarcar	ẽbɐɾkaɾ
embargo	ẽbaɾɣu
embolar	ĩbolaɾ
embolar	ĩbolaχ
embora	ẽbɔɾɐ
emboscada	ẽbuʃkadɐ
emboscar	ẽbuʃkaɾ
embrulhado	ẽbɾuʎaðu
embrulhar	ẽbɾuʎaɾ
embrulho	ẽbɾuʎu
emburrecer	ĩbuʁeseɾ
emburrecer	ĩbuʁeseχ
emburrecimento	ĩbuʁesimẽtu
eme	ɛmɨ
emendar	imẽdaɾ
ementa	imẽtɐ
emigrante	imiɣɾɐ̃tɨ
emigrante	emiɣɾɐ̃tɨ
emitir	imitiɾ
emoção	imusɐ̃w̃
emoldurar	imoɫduɾaɾ
empáfia	ĩpafjɐ
empate	ẽpatə
empecilho	ĩpesiʎu
empenho	ẽpeɲu
empenho	ẽpɐɲu
empenho	ẽpɐjɲu
empertigar	empeɾtiɣaɾ
empreender	ẽpɾjẽdeɾ
empregado	ẽpɾɨɣaðu
empregar	ẽpɾɨɣaɾ
emprego	ẽpɾeɣu
emprego	ẽpɾɛɣu
empunhar	ẽpuj̃aɾ
empurrar	ẽpuʁaɾ
emu	emu
emulação	imulɐsɐ̃w̃
encafifar	ĩkafifaɾ
encaixilhar	ẽkajʃiʎaɾ
encaixotar	ẽkajʃutaɾ
encalço	ĩkawsu
encalistrar	ĩkalistɾaɾ
encalistrar	ĩkalijʃtɾaʁ
encantação	ẽkɐ̃tɐsɐ̃w̃
encantado	ẽkɐ̃tadu
encantar	ẽkɐ̃taɾ
encanto	ẽkɐ̃tu
encarnação	ẽkɐɾnɐsɐ̃w̃
encarnado	ēkɐɾnadu
encavacar	ĩkavakaɾ
encenação	ẽsɨnɐsɐ̃w̃
enchendo	ẽʃẽdu
encher	ẽʃeɾ
enchimento	ẽʃimẽtu
ênclise	ẽklizi
encolher	ẽkuʎeɾ
encolheu	ẽkuʎew
encolhido	ẽkuʎiðu
encomenda	ẽkumẽdɐ
encomendar	ẽkumẽdaɾ
encontrado	ẽkõtɾaðu
encontrão	ẽkõtɾɐ̃w̃
encontrar	ẽkõtɾaɾ
encontro	ẽkõtɾu
encorajamento	ẽkuɾɐʒɐmẽtu
encorajar	ẽkuɾɐʒaɾ
encosta	ẽkɔʃtɐ
encostado	ẽkuʃtaðu
encostar	ẽkuʃtaɾ
endomingado	ẽdumĩɡaðu
endoscopia	ẽdoskopia
endoscopia	ĩdoskopia
endoscopia	ẽdoʃkopia
endoscopia	ĩdoʃkopia
endurecer	ẽduɾɨseɾ
ene	ɛnɨ
eneágono	ɛnjaɣunu
energia	inɨɾʒiɐ
enérgico	inɛɾʒiku
enervar	inɨɾvaɾ
enfermaria	ẽfɨɾmɐɾiɐ
enfermeiro	ẽfɨɾmɐjɾu
enfermidade	ẽfɨɾmiðaðɨ
enfiar	ẽfjaɾ
enfim	ẽfĩ
enfrentar	ẽfɾẽtaɾ
enfurecer	ẽfuɾɨseɾ
enganar	ẽɡɐnaɾ
engano	ẽɡɐnu
engano	ĩɡɐnu
enganoso	ẽɡɐnozu
engarrafamento	ẽɡɐʁɐfɐmẽtu
engarrafar	ẽɡɐʁɐfaɾ
engavete	ẽɡavɛtʃi
engenho	ẽʒeɲu
engenho	ẽʒɐɲu
engenho	ẽʒɐjɲu
engordar	ẽɡuɾðaɾ
engordar	ĩɡuɾðaɾ
engorgitamentos	ẽɡoʁʒitamẽtus
engrandecer	ẽɡɾɐ̃dɨseɾ
enguia	ẽɡiɐ
enguiçar	ẽɡisaɾ
enguiço	ẽɡisu
enjoar	ẽʒwaɾ
enjoo	ẽʒou
enlevo	ej̃levu
enlouquecer	ẽlowkɨseɾ
enojar	inuʒaɾ
enorme	inɔɾmɨ
enormemente	inɔɾmɨmẽtɨ
enquadramento	ẽkwɐðɾɐmẽtu
enquadrar	ẽkwɐðɾaɾ
enquanto	ẽkwɐ̃tu
enriquecer	ẽʁikɨseɾ
ensinar	ẽsinaɾ
ensino	ẽsinu
ensonado	ẽsunaðu
entalhe	ẽtaʎɨ
entanto	ẽtɐ̃tu
então	ẽtɐ̃w̃
ente	ẽtɨ
enteado	ẽtjaðu
entediar	ẽted͡ʒiaɾ
entediar	ĩted͡ʒiaɾ
entediar	ĩted͡ʒjaɾ
entediar	ẽted͡ʒiaɹ
entediar	ĩted͡ʒiaɹ
entediar	ĩted͡ʒjaɹ
entediar	ẽted͡ʒiaɾ
entediar	ĩted͡ʒiaɾ
entediar	ĩted͡ʒjaɾ
entediar	ẽted͡ʒiaɻ
entediar	ĩted͡ʒiaɻ
entediar	ĩted͡ʒjaɻ
entender	ẽtẽdeɾ
entendido	ẽtẽdiðu
entendimento	ẽtẽdimẽtu
enterrado	ẽtɨʁaðu
enterrar	ẽtɨʁaɾ
entra	ẽtɾɐ
entrada	ẽtɾaðə
entrando	ẽtɾɐ̃du
entrar	ẽtɾaɾ
entrava	ẽtɾavɐ
entre	ẽtɾɨ
entreaberto	ẽtɾjɐβɛɾtu
entregador	ĩtɾeɡadoɾ
entregador	ĩtɾeɡadoχ
entregar	ẽtɾɨɣaɾ
entregou	ẽtɾɨɣow
entremeio	ẽtɾemeiu
entremez	ẽtɾɨmeʃ
entretanto	ẽtɾɨtɐ̃tu
entretenimento	ẽtɾɨtɨnimẽtu
entrevistar	ẽtɾɨviʃtaɾ
entristecer	ẽtɾiʃtɨseɾ
entroncamento	ẽtɾõkɐmẽtu
entroncamento	ẽtɾõkɐmẽtu
entrou	ẽtɾow
entusiasmar	ẽtuzjɐʒmaɾ
entusiasmo	ẽtuzjaʒmu
entusiasta	ẽtuzjaʃtɐ
entusiasticamente	ẽtuzjaʃtikɐmẽtɨ
entusiástico	ẽtuzjaʃtiku
envelhecer	ẽvɨʎɨseɾ
envelhecimento	ẽvɨʎɨsimẽtu
envelope	ẽvɨlɔpɨ
envencilhar	ẽvẽsiʎaɾ
envencilhar	ẽvẽsiʎaχ
envenenamento	ẽvɨnɨnɐmẽtu
envenenar	ẽvɨnɨnaɾ
envergonhado	ẽvɨɾɣuɲaðu
envergonhar	ẽvɨɾɣuɲaɾ
enviar	ẽvjaɾ
envio	ẽviu
envólucro	ĩvɔlukɾu
envolver	ẽvoɫveɾ
enxaguar	ẽʃɐɡwar
enxame	ẽʃɐmɨ
enxofre	ẽjʃofɾi
enxuto	ẽʃutu
eoo	eɔu
epidemia	epiðɨmiɐ
epidemia	ipiðɨmiɐ
epigênese	epiʒenezi
epigenesia	epiʒenezia
epigenia	epiʒenia
episódio	ipizɔðju
episódio	epizɔðju
época	ɛpukɐ
epopeia	epopɛjɐ
equidade	ikwiðaðɨ
equino	ekwinu
equinócio	ekinɔsjʊ
equipa	ikipɐ
equipamento	ikipɐmẽtu
equipar	ikipaɾ
equipar	ekipaɾ
equipendência	ikwipẽdẽsiɐ
equivalente	ikivɐlẽtɨ
equivocou	ekivokow
era	ɛɾɐ
eram	ɛɾɐ̃w̃
eremita	iɾɨmitɐ
ergástulo	ɛɾɡaʃtulu
erguendo	iɾɣẽdu
erguer	eɾɡeɾ
erguer	iɾ-
ergueu	eɾɣew
ergueu	iɾɣew
erguido	eɾɣiðu
erguido	iɾɣiðu
ermida	iɾmiðɐ
ermida	eɾmiðɐ
ermo	eɾmu
erradamente	iʁɐðɐmẽtɨ
erradicar	iʀɐðikaɾ
erradicar	eʀɐðikaɾ
errado	iʁaðu
errar	iʁaɾ
erre	ɛʁɨ
erro	eʁu
erro	ɛʁu
erróneo	iʁɔnju
erróneo	eʁɔnju
erva	ɛɾvɐ
ervilha	iɾviʎɐ
ervilha	eɾviʎɐ
és	ɛʃ
esboçar	ɨʒβusaɾ
esboço	ɨʒbosu
esbranquiçado	ɨʒβɾɐ̃kisaðu
esburacar	iʒβuɾɐkaɾ
escabelo	iʃkɐβelu
escachar	ɨʃkɐʃaɾ
escada	iʃkaðɐ
escadaria	eskadaɾia
escadaria	eskadaɾiɐ
escadaria	iskadaɾiɐ
escadaria	eʃkadaɾiɐ
escadaria	iʃkadaɾiɐ
escala	iʃkalɐ
escalar	iʃkɐlaɾ
escândalo	iʃkɐ̃dɐlu
escandinávia	ɨʃkɐ̃dinavjɐ
escanho	iʃkɐɲu
escano	iʃkɐnu
escapar	iʃkɐpaɾ
escaravelho	iʃkɐɾɐveʎu
escaravelho	iʃkɐɾɐvɐjʎu
escarlate	iʃkɐɾlatɨ
escarnecer	iʃkɐɾnɨseɾ
escárnio	iʃkaɾnju
escasso	iʃkasu
escoamento	iʃkwɐmẽtu
escoar	iʃkuaɾ
escoar	iʃkwaɾ
escócia	iʃkɔsiɐ
escola	iʃkɔlɐ
escolha	iʃkoʎɐ
escolher	iʃkuʎeɾ
esconder	ɨʃkõdeɾ
escondido	iʃkõdiðu
esconjurar	iʃkõʒuɾaɾ
esconjuro	iʃkõʒuɾu
escorpião	iʃkuɾpjɐ̃w̃
escorrega	iʃkuʁɛɣɐ
escorregar	iʃkuʁɨɣaɾ
escova	iʃkovɐ
escovar	iʃkuvaɾ
escravização	iʃkɾɐvizɐsɐ̃w̃
escravo	iʃkɾavu
escrever	iʃkɾɨveɾ
escrita	iʃkɾitɐ
escrito	iʃkɾitu
escritor	iʃkɾitoɾ
escritório	iʃkɾitɔɾju
escrivão	iʃkɾivɐ̃w̃
escrúpulo	iʃkɾupulu
escudo	iʃkudu
escultura	ɨʃkuɫtuɾɐ
escumalha	iskumaʎa
escumalha	iʃkumaʎa
escumalho	iskumaʎu
escumalho	iʃkumaʎu
escura	iʃkuɾɐ
escurecer	iʃkuɾɨseɾ
escuridão	iʃkuɾiðɐ̃w̃
escuro	iʃkuɾu
escutar	iʃkutaɾ
esfera	iʃfɛɾɐ
esfera	isfɛɾa
esfera	ijʃfɛɾa
esforçar	iʃfuɾsaɾ
esforço	ɨʃfoɾsu
esfregar	ɨʃfɾɨɣaɾ
esguio	iʒɣiu
eslavo	ɨʒlavu
eslováquia	iʒluvakiɐ
eslovénia	iʒlɔvɛnjɐ
esmagado	iʒmɐɣaðu
esmagamento	ɨʒmɐɣɐmẽtu
esmagar	ɨʒmɐɣaɾ
esmeralda	iʒmɨɾaɫdɐ
esmola	iʒmɔlɐ
espaço	iʃpasu
espaçoso	iʃpɐsozu
espada	ɨʃpadɐ
espadachim	iʃpɐðɐʃĩ
espadas	iʃpadɐʃ
espalhar	ɨʃpɐʎaɾ
espanha	iʃpɐɲɐ
espanhol	ɨʃpɐɲɔɫ
espantado	iʃpɐ̃taðu
espanto	ɨʃpɐ̃tu
espantoso	ɨʃpɐ̃tozu
esparavel	iʃpɐɾɐvɛɫ
especial	iʃpɨsjaɫ
especialidade	iʃpɨsjɐliðaðɨ
especialmente	iʃpɨsjaɫmẽtɨ
espécie	ɨʃpɛsjɨ
espectador	iʃpɛktɐdoɾ
espectro	iʃpɛktɾu
espectro	iʃpɛtɾu
espectro	ɨʃpɛktɾu
espectro	ɨʃpɛtɾu
espelho	ɨʃpɐjʎu
espelho	ɨʃpɛʎu
espelhos	ɛspeʎus
espelhos	ɨʃpeʎuʃ
espera	ɨʃpɛɾɐ
esperança	iʃpɨɾɐ̃sɐ
esperando	iʃpɨɾɐ̃du
esperanto	ispeɾɐ̃tʊ
esperar	ɨʃpɨɾaɾ
esperar	iʃpɨɾaɾ
esperar	ʃpɨɾaɾ
esperava	iʃpɨɾavɐ
esperto	ɨʃpɛɾtu
espesso	iʃpesu
espessura	iʃpɨsuɾɐ
espetáculo	iʃpɛtakulu
espeto	iʃpetu
espeto	iʃpɛtu
espetou	ispetow
espetou	es-
espetou	s-
espiga	iʃpiɣɐ
espinafre	iʃpinafɾɨ
espinha	ɨʃpiɲɐ
espinhaço	ʃpiɲasʊ
espinho	ɨʃpiɲu
espinho	ɨʃpiɲu
espinho	ʃpiɲu
espírito	iʃpiɾitu
espiritual	iʃpiɾitwaɫ
espirrar	iʃpiʁaɾ
espirro	iʃpiʁu
esplêndido	iʃplẽdiðu
esplendor	iʃplẽdoɾ
esponja	ɨʃpõʒɐ
esponsal	iʃpõsaɫ
espora	ɨʃpɔɾɐ
esposa	iʃpozɐ
esposende	ɨʃpɔzẽdɨ
esposo	iʃpozu
espreitar	iʃpɾɐjtaɾ
espreitar	iʃpɾejtaɾ
esquecer	iʃkɛseɾ
esquecido	iʃkɛsiðu
esqueleto	ɨʃkɨletu
esquerda	iʃkeɾðɐ
esquerdino	iʃkɨɾðinu
esquerdo	iʃkeɾðu
esquina	ɨʃkinɐ
esquisito	iʃkizitu
esquisito	iʃkɨzitu
essa	ɛsɐ
essas	ɛsɐʃ
esse	esɨ
esse	ɛsɨ
essência	isẽsjɐ
essencial	isẽsjaɫ
esses	esɨʃ
esta	ɛʃtɐ
está	ʃta
está	ɨʃta
está	iʃta
está	ta
estaca	iʃtakɐ
estação	iʃtɐsɐ̃w̃
estacionamento	iʃtɐsjunɐmẽtu
estacionar	iʃtɐsjunaɾ
estado	iʃtaðu
estalagem	iʃtɐlaʒɐ̃j̃
estalar	iʃtɐlaɾ
estamos	iʃtamuʃ
estância	ɨʃtɐ̃sjɐ
estandarte	iʃtɐ̃daɾtɨ
estando	iʃtɐ̃du
estanho	iʃtɐɲu
estante	iʃtɐ̃tɨ
estão	ɨʃtɐ̃w̃
estar	iʃtaɾ
estar	ɨʃtaɾ
estar	ʃtaɾ
estar	taɾ
estaria	iʃtɐɾiɐ
estarreja	ɨʃtɐʁɐjʒɐ
estas	ɛʃtɐʃ
estás	iʃtaʃ
estatal	ɨʃtɐtal
estátua	iʃtatwɐ
estatura	iʃtatuɾɐ
estatuto	ɨʃtɐtutu
estava	iʃtavɐ
estavam	iʃtavɐ̃w̃
estável	iʃtavɛɫ
este	ɛʃtɨ
este	eʃtɨ
esteio	iʃtɐju
esteio	iʃteju
esteira	iʃtɐjɾɐ
estendendo	iʃtẽdẽdu
estender	iʃtẽdeɾ
estendeu	iʃtẽdew
estes	eʃtɨʃ
estética	ɨʃtɛtikɐ
estético	iʃtɛtiku
estéticos	iʃtɛtikuʃ
esteve	iʃtevɨ
esteve	ɨʃtevɨ
esticado	iʃtikaðu
esticar	iʃtikaɾ
estilete	iʃtileti
estilo	iʃtilu
estilo	ɨʃtilu
estima	iʃtimɐ
estimulador	ɨʃtimulɐðoɾ
estimulante	ɨʃtimulɐ̃tɨ
estio	iʃtiu
estio	ɨʃtiu
estival	iʃtivaɫ
estivar	iʃtivaɾ
estivera	iʃtivɛɾɐ
estivesse	iʃtivɛsɨ
estofado	estofadu
estola	iʃtɔlɐ
estômago	iʃtomɐɣu
estónia	ɨʃtɔniɐ
estontear	iʃtõtjaɾ
estopim	istupĩ
estopim	ijʃtupĩ
estore	iʃtɔɾɨ
estou	ɨʃtow
estourar	iʃtowɾaɾ
estrada	iʃtɾaðɐ
estragar	iʃtɾɐɣaɾ
estrangeiro	iʃtɾɐ̃ʒɐjɾu
estranha	ʃtɾɐɲɐ
estranhar	iʃtɾɐɲaɾ
estranhas	ʃtɾɐɲɐʃ
estranho	iʃtɾɐɲu
estranhos	ʃtɾɐɲuʃ
estratagema	ɨʃtɾɐtɐʒemɐ
estrear	iʃtɾjaɾ
estreia	iʃtɾɐjɐ
estreia	iʃtɾejɐ
estreitar	iʃtɾɐjtaɾ
estreitas	iʃtɾɐjtɐʃ
estreito	iʃtɾɐjtu
estrela	ɨʃtɾelɐ
estrela	iʃtɾelɐ
estrelas	ɨʃtɾelɐʃ
estrelas	iʃtɾelɐʃ
estribilho	iʃtɾiβiʎu
estrondo	ɨʃtɾõdu
estropear	iʃtɾupjaɾ
estrume	ɨʃtɾumɨ
estrumpfe	ɨʃtɾũfɨ
estrutura	iʃtɾutuɾɐ
estrutura	ʃtɾutuɾɐ
estudante	iʃtuðɐ̃tɨ
estudar	iʃtuðaɾ
estudioso	iʃtuðjozu
estudo	iʃtuðu
estufa	iʃtufɐ
estupidamente	iʃtupiðɐmẽtɨ
estúpido	iʃtupidu
esvair	iʒvɐiɾ
esvaziar	iʒvɐzjaɾ
etapa	itapɐ
eternamente	itɛɾnɐmẽtɨ
eternidade	itɨɾniðaðɨ
eterno	itɛɾnu
étimo	ɛtimu
etna	ɛtɨnɐ
etólogo	etɔloɡu
eu	ew
euro	ewɾɔ
euro	ewɾu
europeia	ewɾupɐjɐ
europeu	ewɾupew
euzinha	ewziɲa
euzinho	ewziɲu
evaporação	ivɐpuɾɐsɐ̃w̃
evaporar	ivɐpuɾaɾ
evento	ivẽtu
eventual	ivẽtwaɫ
evidente	iviðẽtɨ
evidentemente	iviðẽtɨmẽtɨ
evitar	ivitaɾ
exame	izɐmɨ
examinar	izɐminaɾ
exatamente	izatɐmẽtɨ
exato	izatu
exausto	izawʃtu
excelência	iʃsɨlẽsjɐ
excelência	ɐjʃsɨlẽsjɐ
excelente	iʃsɨlẽtɨ
excelente	ɐjʃsɨlẽtɨ
excessivamente	iʃsɨsivɐmẽtɨ
excessivamente	ɐjʃsɨsivɐmẽtɨ
excessivo	iʃsɨsivu
excessivo	ɐjʃsɨsivu
excesso	iʃsɛsu
excesso	ɐjʃsɛsu
exceto	ɐjʃsɛtu
exceto	ejʃsɛtu
exceto	iʃsɛtu
excitado	iʃsitaðu
excitado	ɐjʃsitaðu
excitador	ɐjʃsitɐðoɾ
excitador	ɨʃsitɐðoɾ
excitar	iʃsitaɾ
excitar	ɐjʃsitaɾ
exclamar	ɐjʃklɐmaɾ
exclamava	ɐjʃklɐmavɐ
exclamou	iʃklɐmow
exclamou	ɐjʃklɐmow
excremento	iʃkɾɨmẽtu
excremento	ɐjʃkɾɨmẽtu
executivo	ezɨkutivu
executivo	ezɨkutivu
exegese	ezeʒɛzi
exemplar	izẽplaɾ
exemplo	izẽplu
exéquias	ezɛkjas
exequibilidade	ezekwibilidadʒi
exequível	izɨkwivɛɫ
exército	izɛɾsitu
exibido	ezibidu
exibir	ezibiɾ
exibir	ezibiχ
exigência	iziʒẽsjɐ
exigente	iziʒẽtɨ
exigir	iziʒiɾ
exiguidade	iziɣwiðaðɨ
exilar	izilaɾ
exílio	izilju
existência	iziʃtẽsjɐ
existente	iziʃtẽtɨ
existir	iziʃtiɾ
êxito	ɐjzitu
exonerar	izunɨɾaɾ
exoplaneta	ezoplaneta
exótico	ezɔtʃiku
expandir	iʃpɐ̃diɾ
expandir	ɐjʃpɐ̃diɾ
expansão	iʃpɐ̃sɐ̃w̃
expansão	ɐjʃpɐ̃sɐ̃w̃
expectativa	ɐjʃpɛtɐtivɐ
expectativa	ɨʃpɛtɐtivɐ
expedição	ɐjʃpɨdisɐ̃w̃
experimentar	iʃpɨɾimẽtaɾ
experimentar	ɐjʃpɨɾimẽtaɾ
experto	ɐjʃpɛɾtu
experto	ɨʃpɛɾtu
explicação	iʃplikɐsɐ̃w̃
explicação	ʃplikɐsɐ̃w̃
explicação	ɐjʃplikɐsɐ̃w̃
explicações	iʃplikɐsõj̃ʃ
explicações	ʃplikɐsõj̃ʃ
explicações	ɐjʃplikɐsõj̃ʃ
explicado	iʃplikaðu
explicado	ɐjʃplikaðu
explicar	iʃplikaɾ
explicar	ɐjʃplikaɾ
explodir	ɐjʃpluðiɾ
explosão	ɐjʃpluzɐ̃w̃
explosivo	ɐjʃpluzivu
expressão	iʃpɾɨsɐ̃w̃
expressão	ɐjʃpɾɨsɐ̃w̃
exsicante	esikãtʃi
exsicar	esikaɾ
exsicar	esikaʁ
exsudar	ɐjʃsuðaɾ
extração	ɐjʃtɾasɐ̃w̃
extraordinário	ɐjʃtɾɐɔɾðinaɾju
extraordinário	iʃtɾɐɔɾðinaɾju
extravio	istɾaviu
extravio	estɾaviu
extremista	ɐjʃtɾɨmiʃtɐ
extremista	ɨʃtɾɨmiʃtɐ
extremo	iʃtɾemu
extremo	ɐjʃtɾemu
exumação	izumɐsɐ̃w̃
fá	fa
fã	fɐ̃
fábrica	faβɾikɐ
fabricação	fɐβɾikɐsɐ̃w̃
fabricante	faβɾikɐ̃tɨ
fabricar	fɐβɾikaɾ
fábula	fabulɐ
faca	fakɐ
faça	fasɐ
façanha	fɐsɐɲɐ
facão	fakɐ̃w̃
face	fasɨ
facebook	fejzbuk
fachada	fɐʃaðɐ
fácil	fasiɫ
facilmente	fasiɫmẽtɨ
faço	fasu
facto	faktu
fada	faðɐ
fadiga	fɐðiɣɐ
fadigar	fɐðiɣaɾ
fado	faðu
fafe	fafɨ
faiança	fajɐ̃sɐ
faiança	fɐjɐ̃sɐ
faísca	fɐiʃkɐ
fala	falɐ
falado	fɐlaðu
falando	fɐlɐ̃du
falange	fɐlɐ̃ʒɨ
falante	fɐlɐ̃tɨ
falar	fɐlaɾ
falara	fɐlaɾɐ
falará	fɐlɐɾa
falava	fɐlavɐ
falcatrua	faɫkɐtɾuɐ
falecer	fɐlɨseɾ
falena	fɐlenɐ
falha	faʎɐ
falhar	fɐʎaɾ
falo	faɫu
falou	fɐlow
falsidade	faɫsiðaðɨ
falso	faɫsu
faltar	faɫtaɾ
fama	fɐmɐ
família	fɐmiljɐ
faminto	fɐmĩtu
famoso	fɐmozu
fanfarronice	fãfaʁonisi
fantasma	fɐ̃t̪aʒmɐ
faraó	fɐɾɐɔ
farda	faɾðɐ
farejar	fɐɾɨʒaɾ
farelo	fɐɾɛlu
faria	fɐɾiɐ
farinha	fɐɾiɲɐ
farmácia	fɐɾmasjɐ
faro	faɾu
faro	faɾu
farol	fɐɾɔɫ
farra	faʁɐ
farsa	farsɐ
farto	faɾtu
fartura	faɾtuɾa
fartura	faʁtuɾa
fase	fazɨ
fashion	fɛʃõ
fatal	fɐtaɫ
fatalidade	fɐtɐliðaðɨ
fatalismo	fɐtɐliʒmu
fatia	fɐtiɐ
fato	fatu
fatura	fatuɾɐ
fatwa	fatwɐ
fauno	fawnu
faustoso	fawstozu
fava	favɐ
favor	fɐvoɾ
favorável	fəvuɾavɛɫ
favoravelmente	fɐvuɾavɛɫmẽtɨ
favorecer	fɐvuɾɨseɾ
favorecido	fɐvuɾɨsiðu
faz	faʃ
fazem	fazɐ̃j̃
fazendo	fɐzẽdu
fazer	fɐzeɾ
fazes	fazɨʃ
fazia	fɐziɐ
fé	fɛ
febre	fɛβɾɨ
fechada	fɨʃaðɐ
fechadas	fɨʃaðɐʃ
fechado	fɨʃaðu
fechados	fɨʃaðuʃ
fechadura	fɨʃɐðuɾɐ
fechar	fɨʃaɾ
fecho	fɐjʃu
fedelho	fɨðɐʎu
fedelho	fɨðɐjʎu
fedelho	fɨðeʎu
fedelho	fɨðejʎu
feder	fɨðeɾ
federação	fɨðɨɾɐsɐ̃w̃
fedor	fɨðoɾ
fedorento	fɨðuɾẽtu
feição	fɐjsɐ̃w̃
feição	fejsɐ̃w̃
feijão	fɐjʒɐ̃w̃
feijão	fejʒɐ̃w̃
feijoada	fɐjʒwaðɐ
feijoada	fejʒwaðɐ
feio	fɐju
feio	feju
feioso	fejozu
feira	fɐjɾɐ
feira	fejɾɐ
feita	fɐjtɐ
feitas	fɐjtɐʃ
feitiço	fɐjtisu
feitiço	fejtisu
feitio	fɐjtiu
feito	fɐjtu
feitos	fɐjtuʃ
feixe	fɐjʃɨ
feixe	fejʃɨ
felgueiras	fɛɫɡɐjɾɐʃ
felicidade	fɨlisiðaðɨ
felicidade	fɨlɨsiðaðɨ
felino	fɨlinu
feliz	fɨliʃ
felizes	felizɪs
felizmente	fɨliʒmẽtɨ
fêmea	femjɐ
femicídio	femisidʒju
feminicídio	feminisidʒju
feminilidade	fɨminiliðaðɨ
feminilidade	fɨmɨniliðaðɨ
feminino	fɨmininu
feminino	fɨmɨninu
feminismo	fɨmɨniʒmu
fémur	fɛmuɾ
fenestra	fɨnɛʃtɾɐ
feno	fenu
fera	fɛɾa
féria	fɛɾjɐ
férias	fɛɾjɐʃ
ferida	fɨɾidɐ
ferido	fɨɾiðu
ferir	fɨɾiɾ
fernandes	fɨɾnɐ̃dɨʃ
fernandes	feɾnɐ̃dʒis
fernandes	fexnɐ̃dʒiʃ
fernandes	fehnɐ̃ds
ferradura	fɨʁɐðuɾɐ
ferramenta	fɛʁɐmẽtɐ
ferreira	fɨʁɐjɾɐ
ferreira	fɨʁejɾɐ
ferreiro	fɨʁɐjɾu
ferrenho	fɨʁɐjɲu
ferrenho	fɨʁɐɲu
ferro	fɛʁu
ferros	fɛʁuʃ
ferrugem	fɨʁuʒɐ̃j̃
ferrugem	fɨʁuʒẽj̃
fértil	fɛɾtiɫ
fertilizante	fɛɾtilizɐ̃tɨ
ferver	fɨɾveɾ
fervor	fɨɾvoɾ
festa	fɛʃtɐ
feto	fɛtu
feudal	fewðaɫ
feudalismo	fewdalismu
feudalismo	fewdalismo
feudalismo	fewdaliʃmu
feudo	fewdu
fevereiro	fɨvɨɾɐjɾu
fevereiro	fɨvɨɾejɾu
fez	feʃ
fi	fi
fiambre	fjɐ̃bɾɨ
fiar	fjaɾ
fiar	fjaɾ
fica	fikɐ
ficado	fikaðu
ficando	fikɐ̃du
ficar	fikaɾ
ficara	fikaɾɐ
ficará	fikɐɾa
ficaram	fikaɾɐ̃w̃
ficava	fikavɐ
ficção	fiksɐ̃w̃
ficha	fiʃɐ
fico	fiku
ficou	fikow
fictício	fiktisju
fidalgo	fiðaɫɣu
fidalgos	fiðaɫɣuʃ
fiel	fjɛɫ
fígado	fiɡɐdu
figo	fiɡu
figueira	fiɡɐjɾɐ
figueira	fiɡejɾɐ
figueiral	fiɡɐjɾal
figueiral	fiɡejɾal
figueiredo	fiɡɐjɾedu
figueiredo	fiɡejɾedu
figura	fiɣuɾɐ
fila	filɐ
filáucia	filawsjɐ
filé	filɛ
filha	fiʎɐ
filho	fiʎu
filhó	fiʎɔ
filhos	fiʎuʃ
filhote	fiʎɔtɨ
filial	filjaɫ
filigrana	filiɣɾɐnɐ
filme	fiɫmɨ
filosofia	filuzufiɐ
filósofo	filɔzufu
filósofos	filɔzufuʃ
fim	fĩ
fina	finɐ
final	finaɫ
finalização	finɐlizɐsɐ̃w̃
finalizar	finɐlizaɾ
finalmente	finaɫmẽtɨ
finar	finaɾ
findar	fĩdaɾ
findo	fĩdu
fineza	finezɐ
fingimento	fĩʒimẽtu
fingir	fĩʒiɾ
finlândia	fĩlɐ̃diɐ
fino	finu
fins	fĩʃ
fio	fiu
fiquei	fikɐj
fiquei	fikej
firme	fiɾmɨ
firmemente	fiɾmɨmẽtɨ
firula	fiɾula
fisgada	fiʒɣaðɐ
física	fizikɐ
físico	fiziku
fisionomia	fizjunumiɐ
fissurar	fisuɾaɾ
fita	fitɐ
fivela	fivɛlɐ
fixar	fiksaɾ
fixe	fiʃɨ
fixe	fiksɨ
fixo	fiksu
fiz	fiʃ
fizera	fizɛɾɐ
fizera	fizɛɾa
fizeram	fizɛɾɐ̃w̃
flagelo	flɐʒelu
flamengo	flɐmẽɡu
flamífero	flamifeɾu
flamígero	flamiʒeɾu
flamingo	flɐmĩɡu
flanco	flɐ̃ku
flanela	flɐnɛlɐ
flauta	flawta
flauta	flawtɐ
flecha	flɛʃɐ
flor	floɾ
flora	flɔɾɐ
flores	floɾɨʃ
floresta	fluɾɛʃtɐ
florete	fluɾetɨ
florir	fluɾiɾ
florista	fluɾiʃtɐ
fluência	fluẽsja
flume	flumɨ
flúmen	flumɛn
flúmen	flumɐ̃j̃
flúmen	flumẽj̃
fluvial	fluvjaɫ
fluxo	fluksu
fobia	fuβiɐ
foca	fɔkɐ
focinho	fusiɲu
foco	fɔku
fodão	fɔdɐ̃w̃
foder	fudeɾ
fodões	fɔdõj̃s
fodões	fɔdõj̃ʃ
fofo	fofu
fofoca	fɔfɔka
fofura	fofuɾa
fogaça	foɡasa
fogão	fuɣɐ̃w̃
fogaréu	fuɣɐɾɛw
fogo	foɣu
fogueira	fuɣɐjɾɐ
foguete	fuɣetɨ
foi	foj
foice	fojsɨ
folhas	foʎɐʃ
folhear	fuʎjaɾ
folia	fuliɐ
fome	fɔmɨ
fona	fonɐ
fonêmico	fonemiku
fonte	fõtɨ
for	foɾ
fora	fɔɾɐ
fora	foɾɐ
foram	foɾɐ̃w̃
força	foɾsɐ
forçado	fuɾsaðu
forçar	fuɾsaɾ
forças	foɾsɐʃ
forja	fɔɾʒɐ
forma	fɔɾmɐ
forma	foɾmɐ
forma	fɔɾmɐ
formação	fuɾmɐsɐ̃w̃
formado	fuɾmaðu
formador	fuɾmɐðoɾ
formal	fuɾmal
formar	fuɾmaɾ
formiga	fuɾmiɣɐ
formigueiro	fuɾmiɣɐjɾu
formosa	foxmɔza
formosa	fuɾmɔza
formoso	fuɾmozu
fórmula	fɔɾmulɐ
fornalha	fuɾnaʎɐ
fornecimento	fuɾnɨsimẽtu
forno	foɾnu
foro	foɾu
forrado	fuʁaðu
forrar	fuʁaɾ
forro	foʁu
forro	foʁu
forro	fɔʁu
forte	fɔɾtɨ
fortemente	fɔɾtɨmẽtɨ
fortes	fɔɾtɨʃ
fortificação	fɔɾtifikɐsɐ̃w̃
fortuna	fuɾtunɐ
fórum	fɔɾũ
fósforo	fɔʃfuɾu
fosse	fosɨ
fosse	fɔsɨ
fossem	fosɐ̃j̃
foto	fɔtu
fotografia	futuɣɾɐfiɐ
fouce	fowsɨ
fouce	fosɨ
foz	fɔʃ
fração	fɾasɐ̃w̃
fraco	fɾaku
frade	fɾaðɨ
fraga	fɾaɣɐ
fragata	fɾɐɣatɐ
frágil	fɾaʒiɫ
fragilidade	fɾɐʒiliðaðɨ
fragilidade	fɾɐʒɨliðaðɨ
fragrância	fɾɐɣɾɐ̃sjɐ
frágua	fɾaɣwɐ
fralda	fɾaɫdɐ
frança	fɾɐ̃sɐ
francesa	fɾɐ̃sezɐ
franco	fɾɐ̃ku
frângão	fɾɐ̃ɣɐ̃w̃
frango	fɾɐ̃ɡu
fraquejar	fɾɐkɨʒaɾ
fraqueza	fɾɐkezɐ
frasco	fɾaʃku
frase	fɾazɨ
frases	fɾazɨʃ
fraternidade	fɾɐtɨɾniðaðɨ
freguês	fɾɛɣeʃ
freguesia	fɾɛɣɨziɐ
frei	fɾɐj
frei	fɾej
freira	fɾɐjɾɐ
freira	fɾejɾɐ
freire	fɾɐjɾɨ
freire	fɾejɾɨ
freixo	fɾɐjʃu
frente	fɾẽtɨ
frequência	fɾɨkwẽsjɐ
frequentar	fɾɨkwẽtaɾ
fresco	fɾeʃku
frescura	fɾɨʃkuɾɐ
fresta	fɾɛʃtɐ
frete	fɾɛtʃi
fria	fɾiɐ
friagem	fɾiaʒẽj
frialdade	fɾiaɫðaðɨ
frincha	fɾĩʃɐ
frio	fɾiu
frio	fɾiw
friorento	fɾiuɾẽtu
frisa	fɾizɐ
friso	fɾizu
froixo	fɾojʃu
frol	fɾɔɫ
frontal	fɾõtaɫ
fronte	fɾõtɨ
fronteira	fɾõtɐjɾɐ
fronteira	fɾõtɐjɾɐ
frota	fɾɔtɐ
frouxidão	fɾowʃidɐ̃w̃
frouxo	fɾowʃu
fruição	fɾuisɐ̃w̃
fruição	fɾujsɐ̃w̃
fruiteira	fɾujtɐjɾɐ
fruta	fɾutɐ
fruteira	fɾutɐjɾɐ
fruto	fɾutu
fueguino	fwɨɣinu
fugido	fuʒiðu
fugindo	fuʒĩdu
fugir	fuʒiɾ
fugitivo	fuʒitivu
fugiu	fuʒiw
fui	fuj
fuinha	fwiɲɐ
fulá	fula
fulano	fulɐnu
fulgurar	fuɫɡuɾaɾ
fumando	fumɐ̃du
fumar	fumaɾ
fumeante	fumeãtʃi
fumegante	fumeɡãtʃi
fumígeno	fumiʒenu
fumo	fumu
fumoso	fumozu
função	fũsɐ̃w̃
funchal	fũʃaɫ
funchal	fũʃaɫ
funcho	fũʃu
funcionar	fũsjunaɾ
funcionário	fũsjunaɾju
funda	fũdɐ
fundação	fũdɐsɐ̃w̃
fundamentar	fũdamẽtaɾ
fundamentar	fũdamẽtaχ
fundão	fũdɐ̃w
fundão	fũdɐ̃w
fundar	fũdaɾ
fundição	fũdisɐ̃w̃
fundir	fũdiɾ
fundo	fũdu
funeral	funɨɾaɫ
fungar	fũɡaɾ
fungo	fũɡu
fungou	fũɡow
funil	funiɫ
funk	fɐ̃kɨ
funk	fɐ̃k
funks	fɐ̃kis
furão	fuɾɐ̃w̃
fúria	fuɾjɐ
furiosamente	fuɾjɔzɐmẽtɨ
furioso	fuɾiozu
furioso	fuɾjozu
furo	furu
furto	fuɾtu
fusa	fuzɐ
fusão	fuzɐ̃w̃
fusco	fuʃku
fustigar	fuʃtiɣaɾ
futebol	futɯbɔɫ
futicar	futʃikaɾ
futicar	futʃikaʁ
futrica	futɾika
futricada	futɾikada
futricagem	futɾikaʒɐ̃j̃
futricagem	futɾikaʒi
futricar	futɾikaɾ
futricar	futɾikaʁ
futriqueiro	futɾikejɾu
futucar	futukaɾ
futucar	futukaʁ
futuro	futuɾu
fuxicar	fuʃikaɾ
fuxicar	fuʃikaχ
fuxicar	fuʃika
fuxico	fuʃiku
gabinete	ɡɐβinetɨ
gadanha	ɡɐðɐɲɐ
gado	ɡaðu
gafanhoto	ɡɐfɐɲotu
gaiatar	ɡajataɾ
gaiatar	ɡajataχ
gaiatice	ɡajatʃisi
gaiato	ɡajatu
gaio	ɡaju
gaiola	ɡajɔlɐ
gaitar	ɡajtaɾ
gaitar	ɡajtaχ
gaivota	ɡajvɔtɐ
gajeiro	ɡaʒɐjɾu
gajeiro	ɡaʒejɾu
galardão	ɡɐlɐɾðɐ̃w̃
galáxia	ɡɐlaksiɐ
galáxia	ɡɐlaksjɐ
galé	ɡɐlɛ
galego	ɡɐleɣu
galera	ɡɐlɛɾɐ
galeria	ɡɐlɨɾiɐ
galgo	ɡaɫɣu
galho	ɡaʎu
galilé	ɡɐlilɛ
galinha	ɡɐliɲɐ
galinheiro	ɡɐliɲɐjɾu
galinheiro	ɡɐliɲejɾu
galiza	ɡɐlizɐ
galo	ɡalu
gamar	ɡɐmaɾ
gamo	ɡɐmu
gancho	ɡɐ̃ʃu
ganhador	ɡɐɲɐðoɾ
ganhão	ɡɐɲɐ̃w̃
ganhar	ɡaɲaɾ
ganhar	ɡɐɲaɾ
ganho	ɡaɲu
ganho	ɡɐɲu
ganso	ɡɐ̃su
garantir	ɡɐɾɐ̃tiɾ
garça	ɡaɾsɐ
garfo	ɡaɾfu
garganta	ɡɐɾɣɐ̃tɐ
gari	ɡaɾi
garoto	ɡɐɾotu
garrafa	ɡɐʁafɐ
garrancho	ɡarɐ̃ʃu
garrancho	ɡaxɐ̃ʃu
garrancho	ɡahɐ̃ʃu
garrano	ɡɐʁɐnu
gás	ɡaʃ
gasolina	ɡɐzulinɐ
gástrico	ɡaʃtɾiku
gata	ɡatɐ
gatinha	ɡat͡ʃiɲɐ
gatinha	ɡat͡ʃĩjɐ
gatinho	ɡat͡ʃiɲu
gatinho	ɡat͡ʃĩju
gato	ɡatu
gaúcho	ɡɐuʃu
gávea	ɡavjɐ
gaveta	ɡɐvetɐ
gavião	ɡɐviɐ̃w
gavião	ɡɐvjɐ̃w
gavião	ɡɐviɐ̃w
gê	ʒe
geada	ʒjaðɐ
geado	ʒjaðu
géis	ʒɛjʃ
geladaria	ʒɨlɐðɐɾiɐ
gelado	ʒɨlaðu
gelar	ʒɨlaɾ
geleia	ʒɨlɐjɐ
gelo	ʒelu
gelo	ʒɛlu
gelosia	ʒɨluziɐ
gemer	ʒɨmeɾ
gemido	ʒɨmiðu
general	ʒɨnɨɾaɫ
generalidade	ʒɨnɨɾɐliðaðɨ
género	ʒɛnɨɾu
generosidade	ʒɨnɨɾuziðaðɨ
generoso	ʒɨnɨɾozu
génio	ʒɛnju
genioso	ʒeniozu
genro	ʒẽʁu
gente	ʒẽtɨ
gentil	ʒẽtɨɫ
gentileza	ʒẽtʃilezɐ
gentílico	ʒẽtʃiliku
geocêntrico	ʒeosẽtɾiku
geórgia	ʒjɔɾʒjɐ
geração	ʒɨɾɐsɐ̃w̃
geracional	ʒɨɾɐsjunaɫ
gerador	ʒɨɾɐðoɾ
geral	ʒɨɾaɫ
gerar	ʒɨɾaɾ
geringonça	ʒɨɾĩɡõsɐ
gesso	ʒesu
gestão	ʒɨʃtɐ̃w̃
gesto	ʒɛʃtu
gibão	ʒiβɐ̃w̃
giga	ʒiɣɐ
gigabit	ʒiɡabit͡ʃi
gigabit	ʒiɡabiti
gigabyte	ʒiɡabajtʃi
gigó	ʒiɡɔ
gigô	ʒiɡo
gigote	ʒiɡɔtʃi
gilete	ʒilɛtʃi
gim	ʒĩ
ginásio	ʒinazju
ginástica	ʒinaʃtikɐ
gineta	ʒinetɐ
ginga	ʒĩɡɐ
giovana	ʒiovɐna
girafa	ʒiɾafɐ
girassóis	ʒiɾɐsɔjʃ
girassol	ʒiɾɐsɔɫ
giro	ʒiru
giz	ʒis
giz	ʒiʃ
gládio	ɡlaðju
glande	ɡlɐ̃dɨ
glauco	ɡlawku
gleba	ɡlɛba
globo	ɡloβu
glorificação	ɡloɾifikasɐ̃w̃
glorioso	ɡluɾjozu
glúten	ɡlutɛn
gnomo	ɡnomu
goa	ɡoɐ
godo	ɡodu
góes	ɡɔjʃ
gói	ɡɔj
góis	ɡɔjʃ
goivo	ɡojvu
gola	ɡɔlɐ
golegã	ɡulɨɣɐ̃
golfinho	ɡoɫfiɲu
golo	ɡolu
golo	ɡɔlu
golpe	ɡɔɫpɨ
golpelha	ɡoɫpejʎɐ
golpelha	ɡoɫpɐjʎɐ
gomes	ɡomɨʃ
gomo	ɡomu
gôndola	ɡõdulɐ
gondomar	ɡõdumaɾ
google	ɡuɡoɫ
google	ɡuɡow
gorda	ɡoɾðɐ
gordo	ɡoɾðu
gordura	ɡuɾðuɾɐ
gorila	ɡuɾilɐ
gostar	ɡuʃtaɾ
gostava	ɡuʃtavɐ
gota	ɡotɐ
gota	ɡɔtɐ
goteira	ɡotejɾa
gótico	ɡɔtiku
gouveia	ɡowvɐjɐ
governador	ɡuvɨɾnɐðoɾ
governar	ɡuvɨɾnaɾ
governo	ɡuveɾnu
gozando	ɡuzɐ̃du
gozar	ɡuzaɾ
gozo	ɡozu
gozo	ɡɔzu
graça	ɡɾasɐ
graças	ɡɾasɐʃ
gracejar	ɡɾɐsɨʒaɾ
gracioso	ɡɾɐsjozu
grade	ɡɾaðɨ
grado	ɡɾaðu
graduação	ɡɾɐðwɐsɐ̃w̃
gradualmente	ɡɾɐdwaɫmẽtɨ
grafo	ɡɾafu
grama	ɡɾɐ̃mɐ
gramatical	ɡramatʃikaw
grampo	ɡɾɐ̃pu
grana	ɡrɐnɐ
grande	ɡɾɐ̃dɨ
grande	ɡɾɐ̃d
grandes	ɡɾɐ̃dɨʃ
grândola	ɡɾɐ̃dulɐ
granito	ɡɾɐnitu
granja	ɡɾɐ̃ʒɐ
grânulo	ɡɾɐnulu
grão	ɡɾɐ̃w̃
gratuito	ɡɾatujtu
gratuito	ɡɾatuitu
grau	ɡɾaw
gravata	ɡɾɐvatɐ
grave	ɡɾavɨ
gravidade	ɡɾɐviðaðɨ
gravura	ɡɾɐvuɾɐ
graxa	ɡɾaʃa
graxo	ɡɾaʃu
grécia	ɡɾɛsiɐ
grego	ɡɾeɣu
grei	ɡrej
grei	ɡrɛj
grelo	ɡɾelu
grémio	ɡɾɛmju
grenha	ɡɾeɲɐ
grife	ɡɾifi
grifo	ɡɾifu
grilo	ɡɾilu
grinalda	ɡɾinaɫðɐ
gris	ɡɾiʃ
grisalho	ɡɾizaʎu
grisu	ɡɾizu
gritando	ɡɾitɐ̃du
gritar	ɡɾitaɾ
grito	ɡɾitu
gritos	ɡɾituʃ
gritou	ɡɾitow
groselha	ɡɾɔzɐjʎɐ
groselha	ɡɾɔzejʎɐ
grosseiro	ɡɾusɐjɾu
grosseiro	ɡɾusejɾu
grosso	ɡɾosu
grupo	ɡɾupu
gruta	ɡɾutɐ
guadiana	ɡwɐdjɐnɐ
guapo	ɡwapu
guarda	ɡwaɾdɐ
guarda	ɡwaɾdɐ
guardado	ɡwɐɾðaðu
guardanapo	ɡwɐɾðɐnapu
guardar	ɡwɐɾðaɾ
guarida	ɡwaɾida
guarita	ɡwaɾita
guarnecer	ɡwɐɾnɨseɾ
guarujá	ɡwaɾuʒa
gude	ɡudʒi
guê	ɡe
guepardo	ɡɨpaɾðu
guerra	ɡɛʁɐ
guia	ɡiɐ
guião	ɡjɐ̃w̃
guiar	ɡjaɾ
guiar	ɡiaɾ
guilherme	ɡiʎɛɾmɨ
guinéu	ɡinɛw
guisa	ɡizɐ
guita	ɡitɐ
guitarra	ɡitaʁɐ
guizo	ɡizu
gulodice	ɡulodʒisi
gulosice	ɡulozisi
gunda	ɡũdɐ
guri	ɡuɾi
guru	ɡuɾu
h	ɐɣa
há	a
habilidade	abiliðaðɨ
habitação	ɐβitɐsɐ̃w̃
habitante	ɐbitɐ̃tɨ
habitar	ɐβitaɾ
hábito	aβitu
haia	ajɐ
haja	aʒɐ
hamburger	ɐ̃burɡer
hangul	ɐ̃ɡul
harmonia	ɐɾmuniɐ
harmonioso	ɐɾmunjozu
harmonizar	ɐɾmunizaɾ
harpa	aɾpɐ
hasta	aʃtɐ
haste	aʃtɨ
hater	ʁejteɾ
havai	avaj
havendo	ɐvẽdu
haver	ɐveɾ
haverá	ɐvɨɾa
haveria	ɐvɨɾiɐ
havia	ɐviɐ
hebreia	iβɾɐjɐ
hebreia	iβɾejɐ
hebreu	iβɾew
hécate	ɛkɐtɨ
hei	ej
hein	ẽj̃
heleno	ilɛnu
heliocêntrico	ɛljosẽtɾiku
henrique	ẽʁikɨ
henriques	ẽʁikɨʃ
heptágono	ɛptaɣunu
heráldico	eɾaɫdiku
heráldico	ɛɾaɫdiku
herança	iɾɐ̃sɐ
herança	eɾɐ̃sɐ
heranças	ɪɾãsəʃ
herdar	eɾðaɾ
herdar	eɾdaɾ
herdeiro	iɾðɐjɾu
herdeiro	iɾðejɾu
herdeiro	eɾðɐjɾu
herdeiro	eɾðejɾu
herói	eɾɔj
herói	iɾɔj
hétero	ɛteɾu
heterossexual	ɛteɾuseksuaɫ
hexa	ɛksa
hexágono	ɛzaɣunu
hibernal	iβɨɾnaɫ
hibernar	iβɨɾnaɾ
hidrelétrico	idɾelɛtɾiku
hidroelétrico	idɾoelɛtɾiku
hidrogénio	idɾɔʒɛniu
hidrografia	idɾoɡɾafia
hiena	jenɐ
higiene	iʒjɛnɨ
higienização	iʒienizasɐ̃w̃
hindu	ĩdu
hino	inu
hipódromo	ipɔðɾumu
hipogrifo	ipɔɣɾifu
hipopótamo	ipɔpɔtɐmu
hipótese	ipɔtəzə
hirto	iɾtu
história	iʃtɔɾjɐ
histórias	iʃtɔɾjɐʃ
historicamente	iʃtɔɾikɐmẽtɨ
histórico	iʃtɔɾiku
hodiernamente	odʒieɾnamẽtʃi
hoje	oʒɨ
holanda	ɔlɐ̃dɐ
holandês	ɔlɐ̃deʃ
holofote	ɔlɔfɔtɨ
homem	ɔmẽɪ̯
homenagem	ɔmɨnaʒɐ̃j̃
homenagem	ɔmɨnaʒẽj̃
homologação	omoloɡasɐ̃w̃
homossexual	omoseksuaɫ
honestidade	unɛʃtiðaðɨ
honesto	onɛʃtu
honesto	ɔnɛʃtu
honesto	unɛʃtu
honra	õʁɐ
honrado	õʁaðu
honroso	õʁozu
hóplon	ɔplõ
hora	ɔɾɐ
horário	ɔɾaɾju
horário	oɾaɾju
horário	uɾaɾju
horas	ɔɾɐʃ
horizonte	ɔɾizõtɨ
horrível	ɔʁivɛɫ
horror	ɔʁoɾ
horta	ɔɾtɐ
horta	ɔɾtɐ
hortelã	ɔɾtɨlɐ̃
hortelão	ɔɾtɨlɐ̃w̃
hospedagem	ɔʃpɨðaʒɐ̃j̃
hospício	ɔʃpisju
hospital	ɔʃpitaɫ
hospitalar	ɔʃpitɐlaɾ
hospitaleiro	ɔʃpitɐlɐjɾu
hospitalidade	ɔʃpitɐliðaðɨ
hospitalizar	ɔʃpitɐlizaɾ
hoste	ɔʃtɨ
hostil	uʃtiɫ
hotel	ɔtɛɫ
houve	owvɨ
houvesse	owvɛsɨ
hulha	uʎɐ
humana	umanɐ
humanidade	umɐniðaðɨ
humano	umɐnu
humidade	umiðaðɨ
húmido	umiðu
humildade	umiɫðaðɨ
humilde	umiɫdɨ
humilhação	umiʎɐsɐ̃w̃
humo	umu
humor	umoɾ
húmus	umuʃ
hungria	ũɡɾiɐ
ia	iɐ
iam	iɐ̃w̃
iate	jatɨ
ibéria	iβɛɾjɐ
ibérico	iβɛɾiku
iberismo	iβɨɾiʒmu
içado	isaðu
içar	isaɾ
iço	isu
ícone	ikɔnɨ
ícone	ikunɨ
icônico	ikoniku
ida	iðɐ
idade	iðaðɨ
ideal	iðjaɫ
ideia	iðɐjɐ
ideia	iðejɐ
ideias	iðɐjɐʃ
identidade	idẽtiðaðɨ
ideologia	iðjuluʒiɐ
idílio	iðilju
idioma	iðjomɐ
idiossincrasia	iðjɔsĩkɾɐziɐ
ido	iðu
idolatrar	iðulɐtɾaɾ
ídolo	iðulu
idoso	iðozu
ignaro	iɡnaɾu
ignóbil	iɡnɔβiɫ
igreja	iɣɾɐʒɐ
igreja	iɣɾɐjʒɐ
igreja	iɣɾeʒɐ
igreja	iɣɾejʒɐ
igrejas	iɡɾɐjʒɐʃ
igual	iɣwaɫ
igualdade	iɣwaɫdaðɨ
igualha	iɣwaʎɐ
igualmente	iɣwaɫmẽtɨ
ilegal	ilɨɣaɫ
ilha	iʎɐ
ilharga	iʎaɾɣɐ
ílhavo	iʎɐvu
iludir	iluðiɾ
iluminação	iluminɐsɐ̃w̃
iluminar	iluminaɾ
ilusão	iluzɐ̃w̃
ilusionista	iluzjuniʃtɐ
ilustração	iluʃtɾɐsɐ̃w̃
ilustrado	iluʃtɾaðu
ilustrar	iluʃtɾaɾ
imagem	imaʒɐ̃j̃
imaginação	imɐʒinɐsɐ̃w̃
imaginar	imɐʒinaɾ
imaginário	imɐʒinaɾiu
imaginário	imɐʒinaɾju
imanência	imanẽsja
imanente	imanẽtʃi
imaterial	imɐtɨɾjaɫ
imbecil	ĩbɨsiɫ
imediatamente	imɨðjatɐmẽtɨ
imenso	imẽsu
imigração	imiɣɾɐsɐ̃w̃
imigrante	imiɣɾɐ̃tɨ
imitar	imitaɾ
imortal	imuɾtaɫ
imóvel	imɔvɛɫ
impaciente	ĩpɐsjẽtɨ
impacto	ĩpaktu
ímpar	ĩpaɾ
impedir	ĩpɨðiɾ
impenetrável	ĩpɨnɨtɾavɛɫ
impera	ĩpɛɾa
imperador	ĩpɨɾɐðoɾ
imperecibilidade	ĩperesibilidadʒi
imperialmente	ĩpɨɾjaɫmẽtɨ
império	ĩpɛɾju
impessoal	ĩmpswal
impessoalidade	ĩpesualidadʒi
impetuoso	ĩpe̞two̞zu
impingir	ĩpĩʒiɾ
implementar	ĩplemẽtaɾ
impopular	ĩpupulaɾ
impopularidade	ĩpupulɐɾiðaðɨ
impor	ĩpoɾ
importância	ĩpuɾtɐ̃sjɐ
importante	ĩpuɾtɐ̃tɨ
importar	ĩpuɾtaɾ
impossibilidade	ĩpusiβiliðaðɨ
impossibilitar	ĩpusiβilitaɾ
impossível	ĩpusivɛɫ
imposto	ĩpoʃtu
impraticabilidade	ĩpratʃikabilidadʒi
impraticável	ĩpratʃikavew
imprensa	ĩpɾẽsɐ
imprescritível	ĩpɾeskritʃivew
impressão	ĩpɾɨsɐ̃w̃
impressionado	ĩpɾɨsjunaðu
impressionante	ĩpɾɨsjunɐ̃tɨ
impressionar	ĩpɾɨsjunaɾ
impressora	ĩpɾɨsoɾɐ
imprevisto	ĩpɾɨviʃtu
imprimir	ĩpɾimiɾ
ímprobo	ĩpɾobu
improvável	ĩpɾuvavɛɫ
impulsionar	ĩpuɫsjunaɾ
impulsivamente	ĩpuɫsivɐmẽtɨ
imundo	imũdu
inacabado	inɐkɐβaðu
incapacidade	ĩkɐpasiðaðɨ
incapacitar	ĩkɐpasitaɾ
incapaz	ĩkɐpaʃ
incendiar	ĩsẽdjaɾ
incendiário	ĩsẽdjaɾju
incêndio	ĩsẽdiu
incêndio	ĩsẽdju
incensar	ĩsẽsaɾ
incenso	ĩsẽsu
incentivar	ĩsẽtivaɾ
incerteza	ĩsɨɾtezɐ
incitador	ĩsitɐðoɾ
inclinação	ĩklinɐsɐ̃w̃
inclinado	ĩklinaðu
inclinar	ĩklinaɾ
incluso	ĩkluzu
incolumidade	ĩkolumidadʒi
incómodo	ĩkɔmuðu
incomparável	ĩkõpɐɾaveɫ
inconstante	ĩkõʃtɐ̃tɨ
inconveniente	ĩkõvɨnjẽtɨ
incorretamente	ĩkuʁɛtɐmẽtɨ
incorreto	ĩkuʁɛtu
incrementar	ĩkremẽtaɾ
incrível	ĩkɾivɛɫ
incumprimento	ĩkũpɾimẽtu
indecente	ĩdɨsẽtɨ
indemne	ĩdẽnɨ
índia	ĩdjɐ
indicador	ĩdikɐðoɾ
indicar	ĩdikaɾ
indiferença	ĩdifɨɾẽsɐ
indiferente	ĩdifɨɾẽtɨ
indiscrição	ĩdiʃkɾisə̃ʊ
indiscrições	ĩdiʃkɾisʊ̃ɪʃ
indispensável	ĩdiʃpẽsavɛɫ
indissociável	ĩdʒisosiavew
indivíduo	ĩdividuu
indivíduo	ĩdividwu
indo	ĩdu
indolente	ĩdulẽtɨ
indústria	ĩduʃtɾjɐ
industrial	ĩduʃtɾjaɫ
inepto	inɛptu
inerência	ineɾẽsja
inexequibilidade	inezekwibilidadʒi
inexequível	inezekwivew
infame	ĩfamɨ
infâmia	ĩfɐmjɐ
infantaria	ĩfɐ̃tɐɾiɐ
infeção	ĩfɛsɐ̃w̃
infelizmente	ĩfɨliʒmẽtɨ
inferior	ĩfɨɾjoɾ
inferno	ĩfɛɾnu
infiltração	ĩfiltɾɐsɐ̃w̃
infindo	ĩfĩdu
inflamação	ĩflɐmɐsɐ̃w̃
inflamatório	ĩflɐmɐtɔɾju
inflamável	ĩflɐmavɛɫ
inflexível	ĩflɛksivɛɫ
influência	ĩflwẽsjɐ
informação	ĩfuɾmɐsɐ̃w̃
informações	ĩfuɾmɐsõj̃ʃ
infrassom	ĩfɾɐsõ
infrassónico	ĩfɾɐsɔniku
ingerência	ĩʒeɾẽsja
inglaterra	ĩɡlɐtɛʁɐ
inglês	ĩɡleʃ
ingratidão	ĩɡɾɐtiðɐ̃w̃
inhapa	iɲapɐ
inicial	inisjaɫ
inicialmente	inisjaɫmẽtɨ
início	inisju
inimigo	inimiɣu
inimizade	inimizaðɨ
iniquidade	inikwidadʒi
iníquo	inikwu
injeção	ĩʒɛsɐ̃w̃
injete	ĩʒɛtʃi
injúria	ĩʒuɾjɐ
inocência	inusẽsjɐ
inocente	inusẽtɨ
inovação	inuvɐsɐ̃w̃
inovar	inuvaɾ
inquisição	ĩkizisɐ̃w̃
insalubre	ĩsɐluβɾɨ
insano	ĩsɐnu
inscrição	ĩʃkɾisɐ̃w̃
insensato	ĩsẽsatu
insensibilidade	ĩsẽsiβɨliðaðɨ
insensivelmente	ĩsẽsivɛɫmẽtɨ
inseticida	ĩsɛtisiðɐ
inseto	ĩsɛtu
insígnia	ĩsiɣnjɐ
insistir	ĩsiʃtiɾ
insolvente	ĩsɔlvẽtɨ
insónia	ĩsɔnjɐ
inspiração	ĩʃpiɾɐsɐ̃w̃
inspirado	ĩʃpiɾaðu
inspirar	ĩspiɾar
inspirar	ĩʃpiɾaɾ
instalação	ĩʃtɐlɐsɐ̃w̃
instalado	ĩʃtɐlaðu
instalar	ĩʃtɐlaɾ
instância	ĩʃtɐ̃sjɐ
instante	ĩʃtɐ̃tɨ
instigador	ĩʃtiɣɐdoɾ
instrução	ĩʃtɾusɐ̃w̃
instruir	ĩʃtɾuiɾ
instrumento	ĩʃtɾumẽtu
instrutor	ĩʃtɾutoɾ
ínsua	ĩswɐ
insubordinação	ĩsuboɾdʒinasɐ̃w̃
insuficiente	ĩsufisjẽtɨ
insulina	ĩsulinɐ
insumo	ĩsumu
insuportável	ĩsupuɾtavɛɫ
insurreição	ĩsuʁɐjsɐ̃w̃
insuscetível	ĩsusetʃivew
intacto	ĩtaktu
inteiramente	ĩtɐjɾɐmẽtɨ
inteiramente	ĩtejɾɐmẽtɨ
inteiro	ĩtɐjɾu
intelectual	ĩtɨlɛktwaɫ
inteligência	ĩtɨliʒẽsjɐ
inteligente	ĩtɨliʒẽtɨ
intenção	ĩtẽsɐ̃w̃
intencionalmente	ĩtẽsjunaɫmẽtɨ
intensamente	ĩtẽsɐmẽtɨ
intento	ĩtẽtu
intercessor	ĩtɨɾsesoɾ
intercorrência	ĩteɾkoʁẽsja
interessante	ĩtɨɾɨsɐ̃tɨ
interessar	ĩtɨɾɨsaɾ
interesse	ĩtɨɾesɨ
interesseiro	ĩteɾesejɾu
interferência	ĩtɨɾfɨɾẽsjɐ
interior	ĩtɨɾioɾ
interiorano	ĩteɾjoɾɐnu
internação	ĩteɾnasɐ̃w̃
internação	ĩteχnasɐ̃w̃
internacional	ĩtɨɾnɐsjunaɫ
internet	ĩtɛɾnɛt
interrobang	ĩtɛʁubɐ̃ɡɨ
intimidade	ĩtimiðaðɨ
íntimo	ĩtimu
intransigência	ĩtrãŋziʒẽsja
introdução	ĩtɾʊdʊsə̃ʊ
introduções	ĩtɾʊdʊsʊ̃ɪʃ
introjetar	ĩtɾoʒetaɾ
intromete	ĩtɾomɛtʃi
inútil	inutiɫ
invadir	ĩvaðiɾ
invariavelmente	ĩvɐɾjavɛɫmẽtɨ
invasão	ĩvazɐ̃w̃
inveja	ĩvɛʒɐ
invenção	ĩvẽsɐ̃w̃
invencível	ĩvẽsivɛɫ
inventar	ĩvẽtaɾ
inverno	ĩvɛɾnu
investigação	ĩvɨʃtiɣɐsɐ̃w̃
investigador	ĩvɨʃtiɣaðoɾ
investigar	ĩvɨʃtiɣaɾ
inviabilidade	ĩviabilidadʒi
invisível	ĩvizivɛɫ
invólucro	ĩvɔlukɾu
ioga	jɔɣɐ
iogurte	jɔɣuɾtɨ
ionosfera	jonosfɛɾa
ionosfera	jonojʃfɛɾa
ipê	ipe
ípsilon	ipsilɔn
ípsilon	ipslɔn
ir	iɾ
ira	iɾɐ
irá	iɾa
iria	iɾiɐ
irlanda	iɾlɐ̃dɐ
irlandês	iɾlɐ̃deʃ
irmã	iɾmɐ̃
irmandade	iɾmɐ̃daðɨ
irmão	iɾmɐ̃w̃
irmãos	iɾmɐ̃w̃ʃ
ironicamente	iɾɔnikɐmẽtɨ
irracional	iʁɐsjunal
irracionalidade	iʁɐsjunaliðaðɨ
irrepreensível	iʁepɾeẽsivew
irresponsabilidade	iʁɨʃpõsɐβiliðaðɨ
irrupção	iʁupsɐ̃w̃
isenção	izẽsɐ̃w̃
isentar	izẽtaɾ
isento	izẽtu
islândia	iʒlɐ̃diɐ
isolação	izulɐsɐ̃w̃
isopor	izopoɾ
isopor	izopoʁ
isopor	izopoɻ
isqueiro	iʃkɐjɾu
israel	iʒʁɐɛɫ
isso	isu
istambul	iʃtɐ̃buɫ
istmo	iʃtmu
isto	iʃtu
itália	italjɐ
itamaraty	itamaɾatʃi
item	itɛm
item	itɐ̃j̃
itera	itɛra
iterar	iteɾaɾ
iterar	iteɾaχ
j	ʒɔta
já	ʒa
jaborandi	ʒɐβuɾɐ̃di
jacarandá	ʒɐkɐɾɐ̃da
jacaré	ʒɐkɐɾɛ
jacinto	ʒɐsĩtu
jacto	ʒaktu
jaez	ʒɐeʃ
jamais	ʒamajʃ
janeiras	ʒɐnɐjɾɐʃ
janeiras	ʒɐnejɾɐʃ
janeireiro	ʒɐnɐjɾɐjɾu
janeireiro	ʒɐnejɾejɾu
janeirento	ʒɐnɐjɾẽtu
janeirento	ʒɐnejɾẽtu
janeiro	ʒɐnɐjɾu
janeiro	ʒɐnejɾu
janela	ʒɐnɛlɐ
janelamento	ʒɐnɨlɐmẽtu
janelão	ʒɐnɨlɐ̃w̃
janelar	ʒɐnɨlaɾ
janelas	ʒɐnɛlɐʃ
janeleiro	ʒɐnɨlɐjɾu
janeleiro	ʒɐnɨlejɾu
janelinha	ʒɐnɨliɲɐ
janelo	ʒɐnelu
jangada	ʒɐ̃ɡaðɐ
jano	ʒɐnu
janota	ʒɐnɔtɐ
janota	ʒɐnɔtɐ
janotar	ʒanotaɾ
janotar	ʒanotaχ
jantar	ʒɐ̃taɾ
japa	ʒapɐ
japão	ʒɐpɐ̃w̃
japonês	ʒɐpuneʃ
japonesa	ʒɐpunezɐ
jaqueta	ʒɐketɐ
jardim	ʒɐɾðĩ
jardinagem	ʒɐɾðinaʒɐ̃j̃
jardinar	ʒɐɾðinaɾ
jardineiro	ʒɐɾðinɐjɾu
jargão	ʒɐɾɣɐ̃w̃
jasmim	ʒɐʒmĩ
jaspe	ʒaʃpɨ
jato	ʒatu
javali	ʒɐvɐli
jeito	ʒɐjtu
jejuar	ʒɨʒwaɾ
jejum	ʒɨʒũ
jejum	ʒəʒũ
jesus	ʒɨzuʃ
joalharia	ʒwɐʎɐɾiɐ
joalheiro	ʒwɐʎɐjɾu
joaninha	ʒwɐniɲɐ
joão	ʒwɐ̃w̃
job	dʒɔbi
joelho	ʒwɐʎu
joelho	ʒwɐjʎu
joelhos	ʒwɐjʎuʃ
jogador	ʒuɣɐðoɾ
jogar	ʒuɣaɾ
jogo	ʒoɡu
jogo	ʒɔɡu
jogral	ʒuɣɾaɫ
joguetar	ʒoɡetaɾ
joguetar	ʒoɡetaχ
joguete	ʒoɡɛtʃi
joia	ʒɔjɐ
joio	ʒoju
jóquer	ʒɔkɛɾ
jorge	ʒɔɾʒɨ
jornais	ʒuɾnajʃ
jornal	ʒuɾnaɫ
jornaleiro	ʒuɾnɐlɐjɾu
jornaleiro	ʒuɾnɐlejɾu
jornalismo	ʒuɾnɐliʒmu
jornalista	ʒuɾnɐliʃtɐ
jornalístico	ʒuɾnɐliʃtiku
jota	ʒɔtɐ
jovem	ʒɔvɐ̃j̃
jovem	ʒɔvẽj̃
juba	ʒuβɐ
judaico	ʒudajku
judaísmo	ʒuðɐiʃmu
judeu	ʒudew
judicial	ʒuðisjaɫ
jugo	ʒuɣu
juiz	ʒuiʃ
juizado	ʒuizadu
juízo	ʒwizu
juju	ʒuʒu
julgamento	ʒuɫɣɐmẽtu
julgar	ʒuɫɣaɾ
julho	ʒuʎu
juliet	ʒuliɛtʃi
jumento	ʒumẽtu
junção	ʒũsɐ̃w̃
junho	ʒuɲu
júnior	ʒunjɔɾ
junta	ʒũtɐ
juntar	ʒũtaɾ
juntas	ʒũtɐʃ
junto	ʒũtu
juntos	ʒũtuʃ
júpiter	ʒupitɛɾ
jura	ʒuɾa
juramento	ʒuɾɐmẽtu
justamente	ʒuʃtɐmẽtɨ
justiça	ʒuʃtisɐ
justo	ʒuʃtu
juventude	ʒuvẽtuðɨ
k	kapɐ
k	kapa
kamikaze	kamikazɨ
karaoke	kaɾaɔkɨ
kawaii	kɐwɐji
kazatchok	kɐzɐt͡ʃɔkɨ
kilobit	kilobit͡ʃi
kilobit	kilobiti
kilobyte	kilobajtʃi
kombi	kõbi
kombi	kombi
kuduro	kuduru
kyat	kjatɨ
la	lɐ
lá	la
lã	lɐ̃
lábia	laβjɐ
lábio	laβiu
lábio	laβju
lábios	laβjuʃ
laboratório	lɐβuɾɐtɔɾju
laçar	lɐsaɾ
lacera	lasɛɾa
laço	lasu
lacração	lakɾasɐ̃w̃
lacrau	lɐkɾaw
lácteo	laktju
ladainha	lɐðɐiɲɐ
ladeira	lɐðɐjɾɐ
ladeira	lɐðejɾɐ
lado	laðu
lados	laðuʃ
ladrão	lɐðɾɐ̃w̃
ladrar	lɐðɾaɾ
lagar	lɐɣaɾ
lagarta	lɐɣaɾtɐ
lagartixa	lɐɣɐɾtiʃɐ
lagarto	lɐɣaɾtu
lago	laɣu
lagoa	lɐɣoɐ
lagoa	lɐɣoɐ
lagos	laɣuʃ
lagos	laɣuʃ
lágrima	laɣɾimɐ
lágrimas	laɣɾimɐʃ
laico	lajku
lama	lɐmɐ
lamego	lɐmeɣu
lamento	lɐmẽtu
lâmina	lɐminɐ
lâmpada	lɐ̃pɐðɐ
lamparina	lɐ̃pɐɾinɐ
lampejo	lɐ̃peʒu
lampejo	lɐ̃pɛʒu
lampião	lɐ̃piɐ̃w̃
lampião	lɐ̃pjɐ̃w̃
lamúria	lamuɾja
lança	lɐ̃sɐ
lançando	lɐ̃sɐ̃du
lançar	lɐ̃saɾ
lancha	lɐ̃ʃɐ
lanche	lɐ̃ʃɨ
lanço	lɐ̃su
lançou	lɐ̃sow
lanterna	lɐ̃tɛɾnɐ
lapa	lapɐ
lápis	lapiʃ
laquê	lake
lar	laɾ
laranja	lɐɾɐ̃ʒɐ
lareira	lɐɾɐjɾɐ
larga	laɾɣɐ
largamente	laɾɣɐmẽtɨ
largar	lɐɾɣaɾ
largas	laɾɣɐʃ
largo	laɾɡu
largos	laɾɣuʃ
largura	lɐɾɣuɾɐ
las	lɐʃ
lasso	lasu
lata	latɐ
latão	lɐtɐ̃w̃
latim	lɐtĩ
lato	latu
lava	lavɐ
lavagem	lɐvaʒɐ̃j̃
lavanda	lɐvɐ̃dɐ
lavar	lɐvaɾ
lavrar	lɐvɾaɾ
lazer	lɐzeɾ
lê	le
lealdade	ljaɫdaðɨ
leão	ljɐ̃w̃
lebre	lɛβɾɨ
lecionar	lesjonaɾ
lecionar	lesjonaχ
lediça	lɨðisɐ
ledice	lɨðisɨ
ledo	leðu
legal	lɨɣaɫ
legislação	lɨʒiʒlɐsɐ̃w̃
legislar	lɨʒiʒlaɾ
legislativo	lɨʒiʒlɐtivu
legítimo	lɨʒitimu
lei	lɐj
lei	lej
leigo	lejɡu
leilão	lɐjlɐ̃w̃
leilão	lejlɐ̃w̃
leira	lɐjɾɐ
leira	lejɾɐ
leitão	lɐjtɐ̃w̃
leitão	lejtɐ̃w̃
leite	lɐjtɨ
leito	lɐjtu
leito	lejtu
leitor	lɐjtoɾ
leituga	lɐjtuɣɐ
leituga	lejtuɣɐ
leitura	lɐjtuɾɐ
lembrança	lẽbɾɐ̃sɐ
lembrar	lẽbɾaɾ
lembrava	lẽbɾavɐ
lembrou	lẽbɾow
lémure	lɛmuɾɨ
lenço	lẽsu
lençol	lẽsɔɫ
lenda	lẽdɐ
lendo	lẽdu
lene	leni
lengalenga	lẽɡɐlẽɡɐ
lenha	leɲɐ
lenha	lejɲɐ
lenha	lɐɲɐ
lenha	lɐjɲɐ
leniência	leniẽsja
lenta	lẽtɐ
lentamente	lẽtɐmẽtɨ
lento	lẽtu
lentos	lẽtuʃ
lepra	lɛpɾɐ
leque	lɛkɨ
ler	leɾ
lésbica	lɛsbikə
lésbica	lɛʃbikə
lésbico	lɛsbiku
lésbico	lɛʃbiku
leste	lɛʃtɨ
leste	leʃtɨ
lesto	lɛʃtu
letónia	lɨtɔnjɐ
letra	letɾɐ
letras	letɾɐʃ
leu	lew
léu	lɛw
leva	lɛvɐ
levado	lɨvaðu
levando	lɨvɐ̃du
levantando	lɨvɐ̃tɐ̃du
levantar	lɨvɐ̃taɾ
levar	lɨvaɾ
levava	lɨvavɐ
leve	lɛvɨ
levou	lɨvow
lezíria	lɨziɾiɐ
lha	ʎɐ
lhas	ʎɐʃ
lhe	ʎɨ
lhe	lɨ
lhes	ʎɨʃ
lho	ʎu
lhos	ʎuʃ
libélula	libɛlulɐ
liberação	liβɨɾɐsɐ̃w̃
liberal	liβɨɾaɫ
liberdade	liβɨɾðaðɨ
liberdade	libɨɾdadɨ
libertação	liβɨɾtɐsɐ̃w̃
libertar	liβɨɾtaɾ
libra	liβɾɐ
lição	lisɐ̃w̃
licença	lisẽsɐ
liceu	lisew
lições	lɪsʊ̃ɪʃ
licranço	likɾɐ̃su
lidar	liðaɾ
líder	liðɛɾ
lidera	lidɛɾa
liderança	liðɨɾɐ̃sɐ
liderar	liðɨɾaɾ
lídimo	liðimu
ligação	liɣɐsɐ̃w̃
ligado	liɣaðu
ligar	liɣaɾ
lilongwe	lilõɡwɛ
lima	lima
lima	limɐ
limão	limɐ̃w̃
limitação	limitɐsɐ̃w̃
limitado	limitaðu
limitar	limitaɾ
limítrofe	lɨmitɾufɨ
limoeiro	limwɐjɾu
limoeiro	limwejɾu
limpando	lĩpɐ̃du
limpar	lĩpaɾ
limpeza	lĩpezɐ
limpo	lĩpu
lince	lĩsɨ
linda	lĩdɐ
lindo	lĩdu
lindos	lĩduʃ
lingerie	lɐ̃ʒeʁi
língua	lĩɡwɐ
linguagem	lĩɡwaʒɐ̃j̃
linguagens	lĩŋwaʒẽʃ
lingual	lĩɡwaɫ
linguiça	lĩɡuisɐ
linguiça	lĩɡwisɐ
linha	liɲɐ
linhas	liɲɐʃ
linho	liɲu
lípsia	lipsjɐ
líquido	likiðu
lírico	liɾiku
lírio	liɾju
lisboa	liʒboɐ
liso	lizu
lista	liʃtɐ
listagem	listaʒẽj̃
lisura	lizuɾa
literatura	litɨɾɐtuɾɐ
litigar	litʃiɡaɹ
litigar	litʃiɡaχ
lítio	litiu
lituânia	litwɐnjɐ
lívido	liviðu
livrar	livɾaɾ
livraria	livɾɐɾiɐ
livre	livɾɨ
livreiro	livrɐjɾu
livremente	livɾɨmẽtɨ
livro	livɾu
livros	livɾʊʃ
lixa	liʃɐ
lixo	liʃu
lo	lu
loa	loɐ
lobo	loβu
lobo	lɔβu
local	lukaɫ
localmente	lukaɫmẽtɨ
lodo	loðu
lógia	lɔʒjɐ
lógica	lɔʒikɐ
lógico	lɔʒiku
logo	lɔɣu
logo	lɔɣu
logo	loɣu
loiça	lojsɐ
loiro	lojɾu
loja	lɔʒɐ
lojista	luʒiʃtɐ
lombo	lõbu
londres	lõdɾɨʃ
longa	lõɡɐ
longanimidade	lõɡɐnimidadʒi
longas	lõɡɐʃ
longe	lõʒɨ
longínquo	lõʒĩkwu
longitude	lõʒituðɨ
longo	lõɡu
longos	lõɡuʃ
lontra	lõtɾɐ
lopes	lɔpɨʃ
los	luʃ
losango	lozɐ̃ɡu
lotado	lutaðu
lotar	lutaɾ
lotear	lutjaɾ
lótus	lɔtuʃ
louça	lowsɐ
louça	losɐ
louco	lowku
loucura	lowkuɾɐ
loulé	lolɛ
loureiro	lowɾɐjɾu
loureiro	lowɾejɾu
loures	lowɾɨʃ
lourinhã	loɾiɲɐ̃
louro	lowɾu
lousa	lowzɐ
lousã	lowzɐ̃
lousada	lowzaðɐ
louvar	lowvaɾ
louvor	lowvoɾ
lua	luɐ
luanda	lwɐ̃dɐ
luar	lwaɾ
lucerna	lusɛɾnɐ
lúcia	lusjɐ
lucrar	lukɾaɾ
lucro	lukɾu
lugar	luɣaɾ
lugares	luɣaɾɨʃ
luge	luːʒ
lume	lumɨ
luminoso	luminozu
lunar	lunaɾ
lunático	lunatiku
lupa	lupɐ
lusitânia	luzitɐnjɐ
lusitano	luzitɐnu
luso	luzu
luso	luzu
lusofobia	luzɔfuβiɐ
lustre	luʃtɾɨ
luta	lutɐ
lutador	lutɐðoɾ
lutar	lutaɾ
luto	lutu
luva	luvɐ
luvas	luvɐʃ
luxemburgo	luʃẽbuɾɣu
luxo	luʃu
luz	luʃ
luzerna	luzɛɾnɐ
luzes	luzɨʃ
luzidio	luzidiu
luzir	luziɾ
má	ma
maça	masɐ
maçã	mɐsɐ̃
macaco	mɐkaku
maçada	mɐsaðɐ
maçaneta	mɐsɐnetɐ
maçante	mɐsɐ̃tɨ
mação	mɐsɐ̃w
mação	mɐsɐ̃w
machado	mɐʃaðu
machico	mɐʃiku
machista	mɐʃiʃtɐ
macho	maʃu
maciço	mɐsisu
macieira	mɐsjɐjɾɐ
macio	mɐsiu
macla	maklɐ
maço	masu
maconha	makoɲa
mácula	makulɐ
madalena	mɐðɐlenɐ
madeira	mɐðɐjɾɐ
madeira	mɐðejɾɐ
madeira	mɐðɐjɾɐ
madrasta	mɐðɾaʃtɐ
madre	maðɾɨ
madrepérola	maðɾɨpɛɾulɐ
madressilva	maðɾɨsilvɐ
madrigal	mɐðɾiɣaɫ
madrinha	mɐðɾiɲɐ
madrugada	mɐðɾuɣaðɐ
madrugar	mɐðɾuɣaɾ
mãe	mɐ̃j̃
mães	mɐ̃j̃ʃ
mafra	mafɾɐ
mafra	mafɾɐ
magia	maʒia
mágico	maʒiku
magistério	maʒistɛɾju
magistério	maʒijʃtɛɾju
magnífico	maɡnifiku
mago	maɣu
mágoa	maɣwɐ
magoar	mɐɣwaɾ
magreza	mɐɣɾezɐ
magro	maɣɾu
magusto	mɐɣuʃtu
maia	majɐ
maia	majɐ
mainel	majnɛɫ
maio	maju
maior	mɐjɔɾ
maioria	mɐjuɾiɐ
mais	majʃ
maisena	majzena
majestade	mɐʒɨʃtaðɨ
mal	maɫ
mala	malɐ
maldição	maldisɐ̃w̃
maldito	maɫditu
maleficiar	malefisiaɾ
maleficiar	malefisiaχ
malefício	malefisju
maléfico	mɐlɛfiku
malga	maɫɣɐ
malha	maʎɐ
malho	maʎu
maligno	mɐliɡnu
maloca	malɔka
malograr	maloɡɾar
malograr	maloɡɾaʁ
maloqueiro	malokejɾu
malquerer	maɫkərer
malta	maɫtɐ
maluco	mɐluku
mama	mɐmɐ
mamã	mɐmɐ̃
mambembe	mɐ̃bẽjbi
mamute	mɐmutɨ
manada	manada
manada	manadɐ
manancial	mɐnɐ̃sjaɫ
mancha	mɐ̃ʃɐ
manchester	mɐ̃tʃɛstɨɾ
manchete	mãʃɛtʃi
manda	mɐ̃dɐ
mandado	mɐ̃daðu
mandarim	mɐ̃dɐɾĩ
mandatário	mɐ̃dɐtaɾju
mandíbula	mɐ̃diβulɐ
mandinga	mãdʒĩɡa
mandingar	mãdʒĩɡaɾ
mandingar	mãdʒĩɡaχ
mandingueiro	mãdʒĩɡejɾu
mando	mɐ̃du
mandorla	mɐ̃dɔɾlɐ
mandou	mɐ̃dow
maneira	mɐnɐjɾɐ
maneiras	mɐnɐjɾɐʃ
maneiro	mɐnɐjɾu
manga	mɐ̃ɡɐ
mangas	mɐ̃ɡɐʃ
mangra	mɐ̃ɡɾɐ
mangual	mɐ̃ɡwaɫ
mangualde	mɐ̃ɡwaɫdɨ
manha	mɐɲɐ
manhã	mɐɲɐ̃
manhãs	mɐɲɐ̃ʃ
manifestação	mɐnifɨʃtɐsɐ̃w̃
manifestante	mɐnifɨstɐ̃tɨ
manifestar	mɐnifɨʃtaɾ
manilha	mɐniʎɐ
manipulação	mɐnipulɐsɐ̃w̃
manipulável	manipulaveɫ
manjar	mɐ̃ʒaɾ
manjar	mɐ̃ʒaʁ
manjar	mɐ̃ʒax
manjar	mɐ̃ʒaʁ
manjar	mɐ̃ʒax
manjericão	mɐ̃ʒɨɾikɐ̃w̃
manjerico	mɐ̃ʒɨɾiku
mano	mɐnu
manobra	mɐnɔβɾɐ
mansão	mɐ̃sɐ̃w̃
mansidão	mɐ̃siðɐ̃w̃
manso	mɐ̃su
manta	mɐ̃tɐ
manteiga	mɐ̃tɐjɣɐ
manteiga	mɐ̃tejɣɐ
manteigas	mɐ̃tɐjɣɐʃ
manteigas	mɐ̃tɐjɣɐʃ
manter	mɐ̃teɾ
mantimento	mɐ̃timẽtu
manual	mɐnwaɫ
manumissão	mɐnumisɐ̃w̃
manuscrito	mɐnuʃkɾitu
mão	mɐ̃w̃
mãos	mɐ̃w̃ʃ
mapa	mapɐ
maputo	mɐputu
maquete	makɛtʃi
máquina	makinɐ
maquinaria	mɐkinɐɾiɐ
mar	maɾ
maracujá	mɐɾɐkuʒa
marafona	mɐɾɐfonɐ
marajá	mɐɾɐʒa
maravilha	mɐɾɐviʎɐ
marca	maɾkɐ
marcação	mɐɾkɐsɐ̃w̃
marcar	mɐɾkaɾ
marcha	maɾʃɐ
marchar	mɐɾʃaɾ
março	maɾsu
maré	mɐɾɛ
maresia	mɐɾɨziɐ
marfim	mɐɾfĩ
margarina	mɐɾɣɐɾinɐ
margem	maɾʒɐ̃j̃
marginal	mɐɾʒinaɫ
maria	mɐɾiɐ
mariana	mɐɾjɐnɐ
marido	mɐɾiðu
marinha	mɐɾiɲɐ
marinheiro	mɐɾiɲɐjɾu
marinheiro	mɐɾiɲejɾu
marinho	mɐɾiɲu
marmelada	mɐɾmɨlaðɐ
marmelo	mɐɾmɛlu
mármore	maɾmuɾɨ
marquês	mɐɾkeʃ
marquesa	mɐɾkezɐ
marquise	maɾkizɨ
marra	maʁa
marrano	mɐʁɐnu
marrento	maʁẽtu
marta	maɾtɐ
marta	maɾtɐ
marte	maɾtɨ
martelar	mɐɾtɨlaɾ
martelo	mɐɾtɛlu
martins	mɐɾtĩʃ
mártir	maɾtiɾ
martírio	mɐɾtiɾju
marujo	mɐɾuʒu
marvão	mɐɾvɐ̃w
marxista	maɾksista
mas	mɐʃ
máscara	maʃkɐɾɐ
mascote	mɐʃkɔtɨ
masculinidade	mɐʃkuliniðaðɨ
masculino	mɐʃkulinu
masmorra	mɐʒmoʁɐ
massa	masɐ
mastro	maʃtɾu
masturbação	maʃtuɾβɐsɐ̃w̃
mata	matɐ
matador	mɐtɐðoɾ
matamatá	matamata
matar	mɐtaɾ
matéria	mɐtɛɾjɐ
maternidade	mɐtɨɾniðaðɨ
matilda	mɐtiɫdɐ
matilde	mɐtiɫdɨ
mato	matu
matosinhos	mɐtuziɲuʃ
mau	maw
máximo	masimu
mazela	mɐzɛlɐ
mc	mɛki
me	mɨ
meação	mjɐsɐ̃w̃
mealha	mjaʎɐ
mealhada	miɐʎaðɐ
mealhada	miɐʎaðɐ
mealheiro	mjɐʎɐjɾu
mealheiro	mjɐʎejɾu
mec	mɛki
mêda	meðɐ
medalha	mɨðaʎɐ
mediação	mɨðjɐsɐ̃w̃
medição	mɨðisɐ̃w̃
medicina	mɨðisinɐ
medicina	mɨðɨsinɐ
médico	mɛdiku
medidor	mɨðiðoɾ
medir	mɨðiɾ
medo	medu
medonho	mɨdoɲu
medrica	medɾika
medricas	medɾikas
medrincas	medɾĩkas
medronheiro	mɨðɾuɲɐjɾu
medronheiro	mɨðɾuɲejɾu
medronho	mɨðɾoɲu
medroso	mɨðɾozu
mega	mɛɡa
megabit	mɛɡabit͡ʃi
megabit	mɛɡabiti
megabyte	mɛɡabajtʃi
meia	mɐjɐ
meigo	mɐjɣu
meigo	mejɣu
meio	mɐju
mel	mɛɫ
melancia	mɨlɐ̃siɐ
melancolia	mɨlɐ̃kuliɐ
melancolicamente	mɨlɐ̃kɔlikɐmẽtɨ
melancólico	mɨlɐ̃kɔliku
melão	mɨlɐ̃w̃
melecar	melekaɾ
melecar	melekaχ
melgaço	mɛɫɣasu
melhor	mɨʎɔɾ
melhores	mɨʎɔɾɨʃ
meliante	meliãtʃi
melindroso	melĩdɾozu
meloa	mɨloɐ
melodia	mɨluðiɐ
melro	mɛɫʁu
membrana	mẽbɾɐnɐ
membro	mẽbɾu
memória	mɨmɔɾjɐ
memorização	mɨmuɾizɐsɐ̃w̃
memorizar	mɨmuɾizaɾ
mencionar	mẽsjunaɾ
mendigar	mẽdiɣaɾ
mendigo	mẽdiɣu
mene	meni
menina	mɨninɐ
meninas	mɨninɐʃ
menino	mɨninu
meninos	mɨninuʃ
menos	menuʃ
mensagem	mẽsaʒɐ̃j̃
mensal	mẽsaɫ
mensalidade	mẽsalidadʒi
menta	mẽtɐ
mental	mẽtaɫ
mentalidade	mẽtɐliðaðɨ
mentalmente	mẽtaɫmẽtɨ
mente	mẽtɨ
mentira	mẽtiɾɐ
menu	mɨnu
menu	mɛnu
mera	mɛɾa
mercado	mɨɾkadu
mercadologia	mɨɾkɐðuluʒiɐ
mercador	mɨɾkɐðoɾ
mercadoria	mɨɾkɐðuɾiɐ
merceeiro	mɨɾsjɐjɾu
merceeiro	mɨɾsjejɾu
merchan	meɾʃã
merchan	meʁʃã
mercúrio	mɨɾkurju
merda	mɛɾdɐ
merdoso	mɘɾdozu
mergulho	mɨɾɣuʎu
merreca	meʁɛka
mértola	mɛɾtulɐ
mês	meʃ
mesa	mezɐ
mesada	mɨzaðɐ
mesclar	mɛʃklaɾ
meses	mezɨʃ
mesma	meʒmɐ
mesmas	meʒmɐʃ
mesmo	meʒmu
mesmo	mehmu
mesmo	memu
mesmos	meʒmuʃ
mesóclise	mezɔklizi
mesquita	mɨʃkitɐ
mestre	mɛʃtɾɨ
meta	mɛtɐ
meta	metɐ
metade	mɨtaðɨ
metafísico	mɛtɐfiziku
metal	mɨtaɫ
mete	mɛtʃi
meter	mɨteɾ
meteu	mɨtew
metido	mɨtiðu
metodista	metodʒistɐ
metralhadora	mɯtɾaʎɐdoɾɐ
metralhadora	mɯtɾaʎɐðoɾɐ
metro	mɛtɾu
meu	mew
meus	mɛu̯ʃ
mexer	mɨʃeɾ
méxico	mɛʃiku
mezinha	mɛziɲɐ
mi	mi
miasma	miaʒmɐ
miasma	mjaʒmɐ
microclima	mikɾɔklimɐ
migalha	miɣaʎɐ
migração	miɣɾɐsɐ̃w̃
migrante	miɣɾɐ̃tɨ
migrar	miɣɾaɾ
migué	miɡɛ
miguel	miɣɛɫ
mil	miɫ
milagre	milaɣɾɨ
milgrada	miɫɣɾaðɐ
milhão	miʎɐ̃w̃
milho	miʎu
militar	militaɾ
mim	mĩ
mimimi	mimimi
mina	minɐ
minar	minaɾ
mineiro	minɐjɾu
minério	minɛɾju
minete	minɛtə
mingar	mĩɡaɾ
mingau	mĩɡaw
míngua	mĩɡwɐ
minguar	mĩɡwaɾ
minguar	mĩɡaɾ
minha	miɲɐ
minhas	miɲɐʃ
minho	miɲu
minhoca	miɲɔkɐ
minhoto	miɲotu
minissaia	minisajɐ
ministro	miniʃtɾu
ministro	mɨniʃtɾu
minuto	minutu
miolo	mjolu
mira	miɾɐ
mira	miɾɐ
miraculoso	miɾɐkulozu
miradoiro	miɾɐðojɾu
miradouro	miɾɐðowɾu
mirandela	miɾɐ̃dɛlɐ
mirandês	miɾɐ̃deʃ
mirar	miɾaɾ
miríade	miɾiɐðɨ
mirra	miʁɐ
mirrar	miʁaɾ
mirtilo	miɾtilu
miserável	mizɨɾavɛɫ
miséria	mizɛɾjɐ
missa	misɐ
missão	misɐ̃w̃
mister	mistɛɾ
mistério	miʃtɛɾju
mistura	miʃtuɾɐ
misturar	miʃtuɾaɾ
mito	mitu
mitra	mitɾɐ
miúdo	miuðu
miúdo	mjuðu
mixe	miʃi
mixuruca	miʃuɾuka
mó	mɔ
mó	mɔ
mô	mo
mobília	muβiljɐ
mobilizador	mobilizadoɾ
moça	mosɐ
moçambique	musɐ̃bikɨ
moção	musɐ̃w̃
moçárabe	musaɾɐbɨ
mochila	muʃilɐ
mocho	moʃu
mocidade	musiðaðɨ
moço	mosu
moda	mɔðɐ
modelo	muðelu
moderno	muðɛɾnu
modificar	muðifikaɾ
modo	mɔðu
modos	mɔðuʃ
moeda	mwɛdɐ
moela	mwɛlɐ
moer	mweɾ
mofo	mofu
mogadouro	muɣɐðowɾu
mogúncia	muɣũsjɐ
moído	mwiðu
moinho	mwiɲu
moinho	muiɲu
moirama	mojɾɐmɐ
moirisma	mojɾiʒmɐ
moita	mojtɐ
moita	mojtɐ
mola	mɔlɐ
moldávia	mɔɫðavjɐ
moldura	moɫduɾɐ
moldura	muɫduɾɐ
mole	mɔlɨ
moletom	moletõ
molhado	muʎaðu
molhar	muʎaɾ
molho	moʎu
molho	mɔʎu
momento	mumẽtu
mona	mona
monarca	munaɾkɐ
monarquia	munɐɾkiɐ
monárquico	munaɾkiku
monção	mõsɐ̃w̃
monção	mõsɐ̃w
monchique	mõʃikɨ
mondar	mõdaɾ
mondego	mõdeɣu
monforte	mõfɔɾtɨ
monge	mõʒɨ
monja	mõʒɐ
monogamia	monoɡɐ̃mia
monogâmico	monoɡɐ̃miku
monotonia	monotonia
monstro	mõʃtɾu
monstruoso	mõstɾuozu
montalegre	mõtɐlɛɣɾɨ
montanha	mõtɐɲɐ
montar	mõtaɾ
monte	mõtɨ
montenegro	mõteneɡɾu
montenegro	mõtineɡɾu
montijo	mõtiʒu
montra	mõtɾɐ
monumento	munumẽtu
mor	mɔɾ
mor	moɾ
mora	mɔɾɐ
mora	mɔɾɐ
morada	muɾaðɐ
morador	muɾɐðoɾ
moradores	muɾɐðoɾɨʃ
moraes	moɾajs
morais	moɾajs
moral	muɾaɫ
morango	muɾɐ̃ɡu
morar	muɾaɾ
morcego	muɾseɣu
morder	muɾðeɾ
mordida	muɾðiðɐ
mordidela	muɾðiðɛlɐ
mordomo	mɔɾðomu
mordomo	muɾðomu
more	mɔɾɨ
moreira	muɾɐjɾɐ
moreira	muɾejɾɐ
moreno	muɾenu
morrendo	muʁẽdu
morrer	muʁeɾ
morrera	muʁeɾɐ
morrerá	muʁɨɾa
morreu	muʁew
morria	muʁiɐ
morrido	muʁiðu
morrinha	muʁiɲɐ
morro	moʁu
morsa	mɔɾsɐ
morta	mɔɾtɐ
mortágua	mɔɾtaɣwɐ
mortal	muɾtaɫ
morte	mɔɾtɨ
morto	moɾtu
mortos	mɔɾtuʃ
mosaico	muzajku
mosca	moʃkɐ
mosquito	muʃkitu
mosteiro	muʃtɐjɾu
mosteiro	muʃtejɾu
mostra	mɔʃtɾɐ
mostrando	muʃtɾɐ̃du
mostrava	muʃtɾavɐ
motivo	mutivu
motor	mutoɾ
motorista	mutuɾiʃtɐ
mouco	mowku
moura	mowɾɐ
mourama	mowɾɐmɐ
mourão	mowɾɐ̃w
mourão	mowɾɐ̃w
mourisco	mowɾiʃku
mourisma	mowɾiʒmɐ
mouro	mowɾu
móveis	mɔvɐjʃ
móvel	mɔvɛɫ
mover	muveɾ
movimentado	muvimẽtaðu
movimento	muvimẽtu
muamba	muãba
muçulmano	musuɫmɐnu
muçununga	musunũɡɐ
muda	muðɐ
mudança	muðɐ̃sɐ
mudar	muðaɾ
mudéjar	mudɛʒaɾ
mudo	muðu
mufti	mufti
mugir	muʒiɾ
mui	mũj̃
mui	muj
muita	mũj̃tɐ
muitas	mũj̃tɐʃ
muitas	mũj̃tɐs
muito	mũj̃tu
muito	mwĩtu
muitos	mũj̃tuʃ
mula	mulɐ
mulato	mulatu
mulher	muʎɛɾ
mulher	muʎɛʁ
mulherão	muʎɛɾɐ̃w̃
mulheres	muʎɛɾɨʃ
multar	muɫtaɾ
multidão	muɫtiðɐ̃w̃
multiúso	muɫtiuzu
mundial	mũdjaɫ
mundo	mũdu
município	munisipju
munir	muniɾ
muralha	muɾaʎɐ
murar	muɾaɾ
murça	muɾsɐ
murça	muɾsɐ
murcho	muɾʃu
mure	muɾɨ
murganho	muɾɣɐɲu
murmurando	muɾmuɾɐ̃du
murmurar	muɾmuɾaɾ
murmurava	muɾmuɾavɐ
murmúrio	muɾmuɾju
muro	muɾu
muros	muɾuʃ
murta	muɾtɐ
murtosa	muɾtɔzɐ
musa	muzɐ
muscular	muʃkulaɾ
músculo	muʃkulu
museu	muzew
musgo	muʒɣu
música	muzikɐ
musical	muzikaɫ
músico	muziku
mutação	mutɐsɐ̃w̃
mutuamente	mutwɐmẽtɨ
mútuo	mutwu
na	nɐ
nababesco	nababesku
nababesco	nababejʃku
nababo	nababu
nabo	nabu
nação	nɐsɐ̃w̃
nacional	nɐsjunaɫ
nacionalidade	nɐsjunɐliðaðɨ
nações	nɐsõj̃ʃ
nada	naðɐ
nadador	nɐðɐðoɾ
nadar	nɐðaɾ
nado	naðu
nágua	naɡwa
náiade	najɐðɨ
naipe	najpɨ
namoro	namoɾu
namoro	namɔɾu
não	nɐ̃w̃
naquela	nɐkɛlɐ
naquelas	nɐkɛlɐʃ
naquele	nɐkelɨ
naqueles	nɐkelɨʃ
naquilo	nɐkilu
narciso	nɐɾsizu
narigudo	nɐɾiɣuðu
nariz	nɐɾiʃ
narval	naɾval
nas	nɐʃ
nasal	nɐzaɫ
nascente	nɐʃsẽtɨ
nasceu	nɐʃsew
nascido	nɐʃsiðu
nascimento	nɐʃsimẽtu
nascimento	nɐsimẽtu
nascimento	nɐʃimẽtu
natação	nɐtɐsɐ̃w̃
natal	nɐtaɫ
natalino	natalinu
natural	nɐtuɾaɫ
naturalidade	nɐtuɾɐliðaðɨ
natureza	nɐtuɾezɐ
nau	naw
naufrágio	nɐufraʒju
navalha	nɐvaʎɐ
navegação	nɐvɨɣɐsɐ̃w̃
navegador	nɐvɨɣɐðoɾ
navegar	nɐvɨɣaɾ
navio	nɐviu
navios	nɐviuʃ
nazaré	nɐzɐɾɛ
nazi	nazi
nazismo	naziʒmu
nè	nɛ
né	nɛ
neblina	nɨβlinɐ
nebuloso	nɨβulozu
necedade	nɨsɨdadɨ
necessário	nɨsɨsaɾju
necessidade	nɨsɨsiðaðɨ
necessitar	nɨsɨsitaɾ
néctar	nɛktaɾ
nectarina	nɛktɐɾinɐ
neerlândia	njerlɐ̃djɐ
negação	nɨɡɐsɐ̃w̃
negar	nɨɣaɾ
negativamente	nɨɣɐtivɐmẽtɨ
negativo	nɨɣɐtivu
negável	nɨɣavɛɫ
nego	nɛɣu
negociar	nɨɣusjaɾ
negócio	nɨɣɔsju
negócios	nɨɣɔsjuʃ
negra	neɣɾɐ
negro	neɡɾu
nela	nɛlɐ
nelas	nɛlɐʃ
nele	nelɨ
neles	nelɨʃ
nem	nɐ̃j̃
nenhum	nɨɲũ
nenhuma	nɨɲumɐ
nenhures	nɨɲuɾɨʃ
neónio	njɔnju
neptuno	nɛptunu
nerd	nɛʁd͡ʒ
nerd	nɛʁd͡ʒi
neri	neɾi
nero	nɛɾu
nervo	neɾvu
nescidade	nɨʃsidadɨ
nescidade	nɨsidadɨ
nescidade	nɨʃidadɨ
néscio	nɛʃsju
néscio	nɛsju
néscio	nɛʃju
nêspera	neʃpɨɾɐ
nessa	nɛsɐ
nessas	nɛsɐʃ
nesse	nesɨ
nesses	nesɨʃ
nesta	nɛʃtɐ
nestas	nɛʃtɐʃ
neste	neʃtɨ
net	nɛtʃi
neta	nɛtɐ
neto	nɛtu
nevão	nɨvɐ̃w̃
nevar	nɨvaɾ
neve	nɛvɨ
névoa	nɛvwɐ
nevoeiro	nɨvwɐjɾu
nexo	nɛksu
nhaca	ɲaka
nhanhanhã	ɲɐɲɐɲɐ̃
nicho	niʃu
nilo	nilu
nim	nĩ
nimbo	nĩbu
ninfa	nĩfɐ
ninguém	nĩɡɐ̃j̃
ninguém	nĩɡẽj̃
ninho	niɲu
ninjete	nĩʒɛtʃi
nisa	nizɐ
nisso	nisu
nisto	niʃtu
nível	nivɛɫ
no	nu
nó	nɔ
nobélio	nuβɛlju
nobre	nɔβɾɨ
nóbrega	nɔbɾeɡa
nobreza	nuβɾezɐ
noção	nusɐ̃w̃
noite	nojtɨ
noites	nojtɨʃ
noiturno	nojtuɾnu
noiva	nojvɐ
noivo	nojvu
nojeira	noʒejɾa
nojo	noʒu
nom	nõ
nome	nomɨ
nomeação	numjɐsɐ̃w̃
nomear	numiaɾ
nomear	numjaɾ
nomes	nomɨʃ
nominal	numinaɫ
nona	nona
nona	nonɐ
nono	nonu
nora	nɔɾɐ
nordeste	nɔɾðɛʃtɨ
nordeste	nɔɾðɛʃtɨ
normais	nɔɾmajʃ
normal	nɔɾmaɫ
normalmente	nuɾmalmẽtɨ
noroeste	nɔɾwɛʃtɨ
norte	nɔɾtɨ
nos	nuʃ
nós	nɔʃ
nós	nɔʃ
nosocómio	nɔzɔkɔmju
nossa	nɔsɐ
nossas	nɔsɐʃ
nosso	nɔsu
nossos	nɔsuʃ
nostalgia	nuʃtaɫʒiɐ
nota	nɔtɐ
notar	nutaɾ
notário	nutaɾju
notas	nɔtɐʃ
notícia	nutisjɐ
noticiário	nutisjaɾju
notícias	nutisjɐʃ
noturno	nɔtuɾnu
noutra	nowtɾɐ
noutras	nowtɾɐʃ
noutro	nowtɾu
noutros	nowtɾuʃ
nova	nɔvɐ
novaes	novajs
novais	novajs
novamente	nɔvɐmẽtɨ
novas	nɔvɐʃ
novecentos	nɔvɨsẽtuʃ
novembro	nuvẽbɾu
noventa	nuvẽtɐ
novidade	nuviðaðɨ
novo	novu
novos	nɔvuʃ
noz	nɔʃ
nu	nu
nua	nuɐ
nuca	nukɐ
nudez	nuðeʃ
num	nũ
numa	numɐ
numera	numɛɾa
numeral	numɨɾaɫ
número	numɨɾu
números	numɨɾuʃ
nunca	nũkɐ
nuvem	nuvɐj̃
nuvens	nuvɐ̃j̃ʃ
ó	ɔ
õ	õ
oásis	oazis
obedecer	ɔβɨðɨseɾ
obesidade	ɔβɨziðaðɨ
obeso	ɔβezu
óbidos	ɔβiðuʃ
objeção	ɔbʒɛsɐ̃w̃
objete	obʒɛtʃi
objetividade	ɔbʒɛtiviðaðɨ
objetivo	ɔbʒɛtivu
objeto	ɔbʒɛtu
oboé	oβwɛ
óbolo	ɔβulu
obra	ɔβɾɐ
obras	ɔβɾɐʃ
obreiro	ɔβɾɐjɾu
obreiro	ɔβɾejɾu
obrigação	ɔβɾiɣɐsɐ̃w̃
obrigada	obɾiɣaðə
obrigado	ɔβɾiɣaðu
obsceno	ɔpʃsenu
obscuridade	ɔbʃkuɾiðaðɨ
obscuro	ɔbʃkuɾu
obsequiar	obzekiaɾ
obsequiar	obzekiaχ
obséquio	obzɛkju
observação	ɔbsɨɾvɐsɐ̃w̃
observar	ɔbsɨɾvaɾ
observatório	ɔbsɨɾvɐtɔɾju
obstante	ɔpʃtɐ̃tɨ
obtenção	ɔbtẽsɐ̃w̃
obter	ɔbteɾ
obtuso	obtuzu
ocasião	ɔkɐzjɐ̃w̃
ocasião	okɐzjɐ̃w̃
oceanário	ɔsjɐnaɾju
oceano	ɔsjɐnu
oceano	ɔsjɐnu
ocidental	ɔsiðẽtaɫ
ocidente	ɔsiðẽtɨ
ócio	ɔsju
ociosidade	ɔsjuziðaðɨ
ocioso	ɔsjozu
oco	oku
octógono	ɔktɔɣunu
óculo	ɔkulu
óculos	ɔkuluʃ
ocupação	ukupɐsɐ̃w̃
odiana	ɔdjɐnɐ
odiar	ɔðjaɾ
ódio	ɔðju
odivelas	odivɛlɐʃ
odor	ɔðoɾ
odor	oðoɾ
odor	uðoɾ
oeiras	oɐjɾɐʃ
oeste	ɔɛʃtɨ
oeste	wɛʃtɨ
ofender	ɔfẽdeɾ
oferecer	ɔfɨɾɨseɾ
oferta	ɔfɛɾtɐ
oferta	ufɛɾtɐ
oficial	ɔfisjaɫ
oficina	ɔfisinɐ
oficina	ufisinɐ
ofício	ɔfisju
oftalmo	oftawmu
ogano	ɔɣɐnu
ogre	ɔɣɾɨ
oi	oj
oiro	ojɾu
oitavo	ojtavu
oiteiro	ojtɐjɾu
oiteiro	ojtejɾu
oitenta	ojtẽtɐ
oito	ojtu
oitocentos	ojtusẽtuʃ
olá	ɔla
oleiros	olɐjɾuʃ
oleiros	olɐjɾuʃ
óleo	ɔlju
olfato	ɔɫfatu
olha	ɔʎɐ
olha	oʎɐ
olhando	ɔʎɐ̃du
olhão	oʎɐ̃w
olhão	oʎɐ̃w
olhar	ɔʎaɾ
olhar	oʎaɾ
olhava	ɔʎavɐ
olhe	ɔʎɨ
olhinho	oʎĩɲu
olhos	ɔʎuʃ
olhou	ɔʎow
oliveira	ɔlivɐjɾɐ
oliveira	olivɐjɾɐ
oliveira	ɔlivejɾɐ
oliveira	olivejɾɐ
oliveira	ɔlivɐjɾɐ
oliveira	olivɐjɾɐ
oliveira	ɔlivejɾɐ
oliveira	olivejɾɐ
olmo	owmu
olvidar	oɫviðaɾ
olvidar	ɔɫviðaɾ
ombro	õbɾu
ombros	õbɾuʃ
ómega	ɔmɨɡɐ
onça	õsɐ
onda	õdɐ
onde	õdɨ
ondulado	õdulaðu
ondular	õdulaɾ
onera	onɛɾa
ónix	ɔnikʃ
ontem	õtɐ̃j̃
ontem	õtẽj̃
opção	ɔpsɐ̃w̃
opera	opɛɾa
ópera	ɔpɨɾɐ
operação	ɔpɨɾɐsɐ̃w̃
operador	ɔpɨɾɐðoɾ
operar	ɔpɨɾaɾ
operário	ɔpɨɾaɾju
opinião	ɔpinjɐ̃w̃
opor	ɔpoɾ
oportunidade	oportunidadʒi
oportunidade	ɔpuɾtuniðaðɨ
oportunismo	ɔpuɾtuniʒmu
oportunista	ɔpuɾtuniʃtɐ
oportuno	ɔpuɾtunu
oposição	ɔpuzisɐ̃w̃
opressão	upɾɨsɐ̃w̃
opróbrio	opɾɔbɾju
optar	uptaɾ
óptico	ɔptiku
opulência	opulẽsja
opulento	opulẽtu
ora	ɔɾɐ
oração	ɔɾɐsɐ̃w̃
oráculo	uɾakulu
oratório	ɔɾɐtɔɾju
órbita	ɔɾβitɐ
ordeiro	ɔɾðɐjɾu
ordem	ɔɾðɐ̃j̃
ordenação	ɔɾðɨnɐsɐ̃w̃
ordenado	ɔɾðɨnaðu
ordenar	ɔɾðɨnaɾ
ordens	ɔɾðɐ̃j̃ʃ
ordinário	ɔɾðinaɾiu
ordinário	ɔɾðinaɾju
orégano	uɾɛɣɐnu
orelha	oɾɐjʎɐ
orelha	ɔɾɐjʎɐ
orelha	oɾejʎɐ
orelha	ɔɾejʎɐ
orelhão	oɾeʎɐ̃w̃
orelhas	oɾɐjʎɐʃ
organização	ɔɾɣɐnizɐsɐ̃w̃
organizado	ɔɾɣɐnizaðu
organizar	ɔɾɣɐnizaɾ
órgão	ɔɾɣɐ̃w̃
orgia	oɾʒia
orgia	oʁʒia
orgulhar	ɔɾɡuʎaɾ
orgulhar	oɾɡuʎaɾ
orgulho	ɔɾɣuʎu
orientação	oɾiẽntasɐ̃w̃
oriente	ɔɾjẽtɨ
origem	ɔɾiʒɐ̃j̃
origem	oɾiʒɐ̃j̃
original	uɾɨʒinaɫ
oriundo	ɔɾiũdu
ornamentar	ɔɾnɐmẽtaɾ
ornamento	ɔɾnɐmẽtu
ornato	ɔɾnatu
orquestra	ɔɾkɛʃtɾɐ
orquídea	ɔɾkiðjɐ
orvalho	ɔɾvaʎu
os	uʃ
os	uz
oscular	oskulaɾ
oslo	ɔʒlu
osso	osu
ossos	ɔsuʃ
ostra	oʃtɾɐ
otaku	otaku
otário	ɔtaɾju
ótico	ɔtiku
otimista	ɔtimiʃtɐ
otimizar	ɔtimizaɾ
ótimo	ɔtimu
otorrino	otoʁinu
ou	ow
ourém	owɾɐ̃j
ouriço	owɾisu
ourique	owɾikɨ
ourives	owɾivɨʃ
ouro	owɾu
ouros	owɾuʃ
outdoor	awtðɔɹɨ
outeiro	owtɐjɾu
outeiro	owtejɾu
outonal	owtunaɫ
outono	owtonu
outra	owtɾɐ
outrem	owtɾɐ̃j̃
outro	owtɾu
outrora	owtɾɔɾɐ
outrora	otɾɔɾɐ
outubro	owtubɾu
ouve	owvɨ
ouvi	owvi
ouvido	owviðu
ouvindo	owvĩdu
ouvir	owviɾ
ouvira	owviɾɐ
ouvirá	owviɾa
ouvisto	owviʃtu
ouviu	owviw
ova	ɔvɐ
ovar	ovaɾ
ovelha	ɔvɐʎɐ
ovelha	ɔvɐjʎɐ
óvni	ɔvni
óvni	ɔvini
ovo	ovu
ovos	ɔvuʃ
oxalá	ɔʃɐla
oxalá	oʃɐla
oxe	oʃ
oxe	oʃe
oxe	oʃi
óxido	ɔksiðu
oxigénio	ɔksiʒɛnju
ozónio	ɔzɔnju
ozono	ɔzonu
pá	pa
pá	pa
paciência	pɐsjẽsjɐ
paciente	pɐsjẽtɨ
pacificar	pɐsifikaɾ
paço	pasu
pacote	pɐkɔtɨ
pacóvio	pakɔvju
pacto	paktu
pactuar	pɐktwaɾ
padaria	paðɐɾiɐ
padeiro	padɐjɾu
padoca	padɔka
padrasto	pɐdɾaʃtu
padre	paðɾɨ
padrinho	pɐðɾiɲu
padroeiro	pɐðɾwɐjɾu
pães	pɐ̃j̃ʃ
pagamento	pɐɣɐmẽtu
pagão	pɐɣɐ̃w̃
pagar	pɐɣaɾ
página	paʒinɐ
pagode	pɐɣɔðɨ
pai	paj
pai	paj
painço	pɐĩsu
painel	pajnɛɫ
pairar	pajɾaɾ
pais	pajʃ
país	pɐiʃ
paisagem	pajzaʒɐ̃j̃
paixão	pajʃɐ̃w̃
pajé	paʒɛ
pajem	paʒɐ̃j̃
pajem	paʒẽj̃
pajubá	paʒuba
palacete	pɐlɐsetɨ
palácio	pɐlasju
paladar	pɐlɐðaɾ
palavra	pɐlavɾɐ
palavras	pɐlavɾɐʃ
palco	paɫku
palha	paʎɐ
páli	pali
pálido	paliðu
palíndromo	pɐlĩdrumu
palmas	paɫmɐʃ
palmela	pɐɫmɛlɐ
palmou	pawmow
pálpebra	paɫpɨβɾɐ
pamonha	pamoɲa
pança	pɐ̃sɐ
pandeiro	pɐ̃dɐjɾu
panela	pɐnɛlɐ
panfleto	pɐ̃fletu
pânico	pɐniku
pano	pɐnu
panos	pɐnuʃ
pântano	pɐ̃tɐnu
pantomima	pɐ̃tumimɐ
pão	pɐ̃w̃
papa	papɐ
papagaio	pɐpɐɣaju
papar	pɐpaɾ
paparazzo	papaɾatsu
paparicar	pɐpɐɾikaɾ
papéis	pəpɛjʃ
papel	pɐpɛɫ
papoila	pɐpojlɐ
papoula	pɐpowlɐ
paquera	pakɛɾa
paquerar	pakeɾaɾ
paquerar	pakeɾaʁ
par	paɾ
para	pɐɾɐ
para	paɾɐ
parabéns	pɐɾɐβɐ̃j̃ʃ
parado	pɐɾaðu
parafuso	pɐɾɐfuzu
paragem	pɐɾaʒɐ̃j̃
paraíso	pɐɾɐizu
paralelo	pɐɾɐlɛlu
parando	pɐɾɐ̃du
parapeito	pɐɾɐpɐjtu
paraquedas	paɾɐkɛðɐʃ
parar	pɐɾaɾ
parara	pɐɾaɾɐ
parará	pɐɾɐɾa
parceiro	pɐɾsɐjɾu
parceiro	pɐɾsejɾu
parcialmente	pɐɾsiaɫmẽtɨ
pardal	pɐɾðaɫ
pardo	paɾðu
parece	pɐɾɛsɨ
parecer	pɐɾɨseɾ
pareceu	pɐɾɨsew
parecia	pɐɾɨsiɐ
pareciam	pɐɾɨsiɐ̃w̃
parecido	pɐɾɨsiðu
parede	pɐɾeðɨ
paredes	pɐɾeðɨʃ
paredes	pɐɾeðɨʃ
parente	pɐɾẽtɨ
pária	paɾjɐ
parir	pɐɾiɾ
parlamento	paɾlamẽtʊ
parlapatão	paɾlapatɐ̃w̃
parlapatice	paɾlapatʃisi
parolar	pɐɾulaɾ
parou	pɐɾow
parque	paɾkɨ
parra	paʁa
parrudo	paʁudu
parte	paɾtɨ
partes	paɾtɨʃ
participar	pɐɾtisipaɾ
particular	pɐɾtikulaɾ
particularmente	pɐɾtikulaɾmẽtɨ
partida	pɐɾtiðɐ
partidário	pɐɾtiðaɾju
partido	pɐɾtiðu
partilhar	pɐɾtiʎaɾ
partir	pɐɾtiɾ
parvo	paɾvu
pascácio	paskasju
pascácio	pajʃkasju
páscoa	paʃkwɐ
paspalho	paspaʎu
passa	pasɐ
passado	pɐsaðu
passados	pɐsaðuʃ
passagem	pɐsaʒɐ̃j̃
passando	pɐsɐ̃du
passar	pɐsaɾ
passara	pɐsaɾɐ
passará	pɐsɐɾa
passaram	pɐsaɾɐ̃w̃
passarinheiro	pɐsɐɾiɲɐjɾu
passarinho	pɐsɐɾiɲu
pássaro	pasɐɾu
passava	pɐsavɐ
passeando	pɐsjɐ̃du
passear	pɐsjaɾ
passeio	pɐsɐju
passo	pasu
passos	pasuʃ
passou	pɐsow
pastel	pɐʃtɛɫ
pastelaria	pɐʃtɨlɐɾiɐ
pasteleiro	pɐʃtɨlɐjɾu
pastor	pɐʃtoɾ
pata	patɐ
patamar	pɐtɐmaɾ
patas	patɐʃ
patinete	patʃinɛtʃi
pátio	patju
pato	patu
patrão	pɐtɾɐ̃w̃
patrazana	patɾazɐ̃na
pátria	patɾjɐ
patriarca	pɐtɾiaɾkɐ
patrício	pɐtɾisju
património	pɐtɾimɔnju
patrono	pɐtɾonu
pau	paw
paul	pɐuɫ
paulistano	pawlistɐnu
paus	pawʃ
pausa	pawzɐ
pauta	pawtɐ
pavão	pɐvɐ̃w̃
pavimento	pɐvimẽtu
pavor	pɐvoɾ
paz	paʃ
pazes	pazɨʃ
pé	pɛ
pê	pe
peão	pjɐ̃w̃
pec	pɛki
peça	pɛsɐ
pecado	pɨkaðu
peçonha	pɨsoɲɐ
pedaço	pɨðasu
pedido	pɨðiðu
pedir	pɨðiɾ
pediu	pɨðiw
pedra	pɛdɾɐ
pedraria	pɨðɾɐɾiɐ
pedras	pɛðɾɐʃ
pedregulho	pɨðɾɨɣuʎu
pedreira	pɨðɾɐjɾɐ
pedreiro	pɨðɾɐjɾu
pega	peɣɐ
pega	pɛɣɐ
pega	pɛɣɐ
pega	pɛɣɐ
pegajoso	pɨɣɐʒozu
pegar	pɨɣaɾ
pego	pɛɣu
pego	peɣu
peguete	peɡɛtʃi
peito	pɐjtu
peixe	pɐjʃɨ
peixe	pejʃɨ
pela	pelɐ
pela	pɛlɐ
pelado	pɨlaðu
pelar	pɨlaɾ
pelas	pelɐʃ
pele	pɛlɨ
pelo	pɨlu
pelo	plu
pelo	pelu
pelo	pɛlu
pelos	peluʃ
pelourinho	pɨlowɾiɲu
pelouro	pɨlowɾu
peluche	pɨluʃɨ
peludo	pɨluðu
pena	penɐ
pena	penɐ
pena	pɛnɐ
penacova	pɨnɐkɔvɐ
penafiel	pɨnɐfiɛɫ
penal	penaɫ
penamacor	penɐmɐkoɾ
penar	pɨnaɾ
penas	penɐʃ
pendão	pẽdɐ̃w̃
pender	pẽdeɾ
pendurar	pẽduɾaɾ
penedo	pɨnedu
penedono	pɨnɨðonu
penela	pɨnɛlɐ
penha	peɲɐ
penha	pejɲɐ
penha	pɐɲɐ
penha	pɐjɲɐ
penhasco	pɨɲaʃku
penhascos	pɨɲaʃkuʃ
peniche	pniʃ
penicilina	pɨnisilinɐ
península	pɨnĩsulɐ
peninsular	penĩsulaɾ
penitência	pɨnitẽsjɐ
pensamento	pẽsɐmẽtu
pensamentos	pẽsɐmẽtuʃ
pensando	pẽsɐ̃du
pensar	pẽsaɾ
pensativo	pẽsɐtivu
pensava	pẽsavɐ
penso	pẽsu
pensoso	pẽsozu
pensou	pẽsow
pentágono	pẽtaɣunu
pente	pẽtɨ
penteado	pẽtjaðu
pentear	pẽtjaɾ
penumbra	pɨnũbɾɐ
pepino	pepinu
pepino	pipinu
pequena	pɨkenɐ
pequenino	pɨkɨninu
pequeno	pɨkenu
pera	peɾɐ
pera	pɛɾɐ
peraí	pɛɾai
perambular	pɯɾɐ̃bulaɾ
perambulava	pɯɾɐ̃bulavɐ
perca	peɾkɐ
perca	pɛɾkɐ
perceber	pɨɾsɨbeɾ
perceção	pɨɾsɛsɐ̃w̃
percorrer	pɨɾkuʁeɾ
percurso	pərkuɾsu
perda	peɾðɐ
perdão	pɨɾdɐ̃w̃
perder	pɨɾðeɾ
perdição	pɨɾðisɐ̃w̃
perdida	pɨɾðiðɐ
perdidamente	pɨɾðiðɐmẽtɨ
perdido	pɨɾðiðu
perdoar	pɨɾdwaɾ
perdulário	peɾdulaɾju
pereba	peɾɛbɐ
perecibilidade	peresibilidadʒi
pereira	pɨɾɐjɾɐ
pereira	pɨɾejɾɐ
pereira	pɨɾɐjɾɐ
pereira	pɨɾejɾɐ
perene	pɨɾɛnɨ
perentoriamente	pɨɾẽtɔɾjɐmẽtɨ
perentório	pɨɾẽtɔɾju
perfeição	pɨɾfɐjsɐ̃w̃
perfeição	pɨɾfejsɐ̃w̃
perfeitamente	pɨɾfɐjtɐmẽtɨ
perfeito	pɨɾfɐjtu
perfil	pɨɾfiɫ
pergunta	pɨɾɣũtɐ
perguntando	pɨɾɣũtɐ̃du
perguntar	pɨɾɣũtaɾ
perguntas	pɨɾɣũtɐʃ
perguntava	pɨɾɣũtavɐ
perguntou	pɨɾɣũtow
perigo	pɨɾiɣu
perigoso	pɨɾiɣozu
período	pɨɾiuðu
permanecer	pɨɾmɐnɨseɾ
permanente	pəɾmanẽtə
permitir	pɨɾmitiɾ
perna	pɛɾnɐ
pernas	pɛɾnɐʃ
pernóstico	peɾnɔstʃiku
pérola	pɛɾulɐ
perónio	pɨɾɔnju
perpendicular	pɨɾpẽdikulaɾ
perplexo	peɾplɛksu
perplexo	peʁplɛksu
perro	peʁu
persa	pɛɾsɐ
perseguição	pɨɾsɨɣisɐ̃w̃
perseguir	pɨɾsɨɣiɾ
personagem	pɨɾsunaʒɐ̃j̃
perspetiva	pɨɾʃpɛtiva
perspetivar	pɨɾʃpɛtivaɾ
pertencer	pɨɾtẽseɾ
perto	pɛɾtu
perturbação	pɨɾtuɾβɐsɐ̃w̃
perturbado	pɨɾtuɾβaðu
perturbador	pɨɾtuɾβaðoɾ
perturbar	perturbar
peru	pɨɾu
peru	pɨɾu
peruca	pɨɾukɐ
perversão	pɨɾvɨɾsɐ̃w̃
pés	pɛʃ
pesadelo	pɨzɐðelu
pesado	pɨzaðu
pesados	pɨzaðuʃ
pesagem	pɨzaʒɐ̃j̃
pesar	pɨzaɾ
pesar	pɨzaɾ
pesca	pɛʃkɐ
pescador	pɨʃkɐðoɾ
pescoço	pɨʃkosu
peso	pezu
peso	pɛzu
pesquisar	peskizaɾ
pêssego	pesɨɣu
pessoa	pɨsoɐ
pessoal	pɨswaɫ
pessoalmente	pɨswaɫmẽtɨ
pessoas	pɨsoɐʃ
pestana	pɨʃtɐnɐ
pestanas	pɨʃtɐnɐʃ
petiz	pətiʃ
petróleo	pɨtɾɔlju
petúnia	pɨtunjɐ
pezinho	pɛziɲu
pezinho	peziɲu
pi	pi
piá	pia
piaçaba	pjasaβɐ
pianinho	piɐniɲu
piano	pjɐnu
pião	pjɐ̃w̃
picadilha	pikad͡ʒiʎɐ
picante	pikɐ̃tɨ
picar	pikaɾ
pichação	piʃasɐ̃w̃
pico	piku
piedade	pjɛðaðɨ
piedoso	pjɛðozu
piemonte	pjɨmõtɨ
pigídio	piʒidju
pijama	piʒɐmɐ
pilha	piʎɐ
pilo	pilu
piloto	pilotu
piloto	pilɔtu
pimenta	pimẽtɐ
pimentão	pimẽtɐ̃w̃
pimento	pimẽtu
pimpão	pĩpɐ̃w̃
pináculo	pinakulu
pincel	pĩsɛɫ
pindaíba	pindaibɐ
pingo	pĩɡu
pinguim	pĩɡwĩ
pinha	piɲɐ
pinheiro	piɲɐjɾu
pinheiro	piɲejɾu
pinhel	piɲɛɫ
pinho	piɲu
pinoia	pinɔja
pinque	pĩkɨ
pinta	pĩtɐ
pintar	pĩtaɾ
pintassilgo	pĩtɐsiɫɣu
pinto	pĩtu
pintor	pĩtoɾ
pintura	pĩtuɾɐ
pinturesco	pĩtuɾeʃku
piolho	pioʎu
piolho	pjoʎu
pior	pjɔɾ
pipa	pipɐ
pipoca	pipɔkɐ
pique	piki
pira	piɾɐ
pirata	piɾatɐ
pires	piɾɨʃ
pires	piɾis
piriguete	piɾiɡɛtʃi
piriguete	peɾiɡɛtʃi
pirilampo	piɾilɐ̃pu
pisar	pizaɾ
piscar	piʃkaɾ
piscina	piʃsinɐ
pistola	piʃtɔlɐ
pitaco	pitaku
pitoresco	pituɾeʃku
pivete	pivɛtʃi
pizza	pizɐ
placebo	plasebu
placenta	plasẽtɐ
planear	plɐnjaɾ
planeta	plɐnetɐ
plano	plɐnu
planta	plɐ̃tɐ
plantação	plɐ̃tɐsɐ̃w̃
plantar	plɐ̃taɾ
plataforma	plɐtɐfɔɾmɐ
plátano	platɐnu
pleito	plejtu
plotador	plotadoɾ
plotador	plotadoʁ
plotadora	plotadoɾa
plotagem	plotaʒɐ̃
plotagem	plotaʒi
plotar	plotaɾ
plotar	plotaʁ
plural	pluɾal
plutão	plutɐ̃w̃
plutónio	plutɔniu
pneu	pnew
pó	pɔ
pô	po
pobre	pɔβɾɨ
pobres	pɔβɾɨʃ
pobreza	puβɾezɐ
pobrezinho	pɔβɾɨziɲu
poção	pusɐ̃w̃
poço	posu
pode	pɔðɨ
pôde	poðɨ
podem	pɔðɐ̃j̃
podemos	puðemuʃ
podendo	puðẽdu
poder	pudeɾ
poder	pudeɾ
poderia	puðɨɾiɐ
poderoso	puðɨɾozu
podes	pɔðɨʃ
podia	puðiɐ
podre	poðɾɨ
poeira	pwɐjɾɐ
põem	põj̃ɐ̃j̃
poema	pwemɐ
poente	pwẽtɨ
poente	puẽtɨ
poesia	pwɛziɐ
poeta	pwɛtɐ
poetisa	pwɛtizɐ
poio	poju
pois	pojʃ
polaco	pulaku
polegar	pulɨɣaɾ
poliandria	poliɐ̃dɾia
poliban	pɔlibɐ̃
polícia	pulisjɐ
polido	puliðu
poligamia	poliɡɐ̃mia
poligâmico	poliɡɐ̃miku
poliginia	poliʒinia
polimento	pulimẽtu
políptico	puliptiku
polir	puliɾ
política	pulitikɐ
político	pulitiku
polivalente	polivalẽtʃi
polo	pɔlu
polo	pɔlu
polo	polu
polo	pulu
polónia	pulɔnjɐ
poltrona	poɫtɾonɐ
poltrona	puɫtɾonɐ
polução	pulusɐ̃w̃
poluição	pulwisɐ̃w̃
poluir	pulwiɾ
polvilho	pɔlviʎu
polvo	poɫvu
pólvora	pɔɫvuɾɐ
pomada	pumaðɐ
pomba	põbɐ
pombal	põbaɫ
pompom	põpõ
poncho	põʃu
pondera	põdɛɾa
pondo	põdu
ponta	põtɐ
pontapé	põtɐpɛ
pontas	põtɐʃ
ponte	põtɨ
ponteiro	põtɐjɾu
pontiagudo	põtjɐɣuðu
ponto	põtu
pontuação	põtwɐsɐ̃w̃
pontualmente	põtwaɫmẽtɨ
pontuar	põtwaɾ
população	populasãw
população	pupulɐsɐ̃w
popularizar	pupulɐɾizaɾ
por	puɾ
pôr	poɾ
porcaria	puɾkɐɾiɐ
porco	poɾku
porcos	pɔɾkuʃ
porém	puɾɐ̃j̃
pornografia	puɾnuɡɾafiɐ
porque	puɾkɨ
porquê	puɾke
porta	pɔɾtɐ
portada	puɾtaðɐ
portal	puɾtaɫ
portalegre	puɾtɐlɛɣɾɨ
portanto	puɾtɐ̃tu
portão	puɾtɐ̃w̃
portar	puɾtaɾ
portas	pɔɾtɐʃ
porteiro	puɾtɐjɾu
portel	puɾtɛɫ
portimão	puɾtimɐ̃w
porto	poɾtu
porto	pɔɾtu
porto	poɾtu
portugal	puɾtuɣaɫ
português	puɾtuɣeʃ
portugueses	puɾtuɣezɨʃ
portuguesismo	puɾtuɣɨziʒmu
portunhol	puɾtuɲɔɫ
porventura	puɾvẽtuɾɐ
pós	pɔʃ
pôs	poʃ
posição	puzisɐ̃w̃
positivo	puzitivu
possa	pɔsɐ
posse	pɔsɨ
possibilidade	pusibilidadɨ
possibilitar	pusiβilitaɾ
possível	pusivɛɫ
possivelmente	pʊsivɛlmɛ̃t̪
posso	pɔsu
postal	puʃtaɫ
posterioridade	puʃtɨɾjoɾiðaðɨ
posteriormente	puʃtɨɾjoɾmẽtɨ
postigo	puʃtiɣu
pote	pɔtɨ
potencialidade	potẽsjalidadʒi
pouca	powkɐ
poucas	powkɐʃ
pouco	powku
poucos	powkuʃ
poupança	powpɐ̃sɐ
poupar	powpar
pousada	powzaðɐ
pousado	powzaðu
pousando	powzɐ̃du
pousar	powzaɾ
poveiro	pɔvejɾu
povo	povu
póvoa	pɔvwɐ
povoação	puvuɐsɐ̃w
povoar	puvwaɾ
povos	pɔvus
pra	pɾɐ
praça	pɾasɐ
prácrito	pɾakɾitu
praga	pɾaɣɐ
praguejar	pɾɐɡəʒaɾ
praia	pɾajɐ
prancha	pɾɐ̃ʃɐ
pranto	pɾɐ̃tu
prateado	pɾɐtjaðu
prateleira	pɾɐtɨlɐjɾɐ
prática	pɾatikɐ
praticabilidade	pratʃikabilidadʒi
prático	pɾatiku
prato	pɾatu
prazenteiro	pɾɐzẽtɐjɾu
prazenteiro	pɾɐzẽtejɾu
prazer	pɾɐzeɾ
prazo	pɾazu
prece	pɾɛsɨ
precedente	pɾɨsɨðẽtɨ
precioso	pɾɨsjozu
precipitadamente	pɾɨsipitaðɐmẽtɨ
precisa	pɾɨsizɐ
precisão	pɾɨsizɐ̃w̃
precisar	pɾɨsizaɾ
preciso	pɾɨsizu
preço	pɾesu
preconceito	pɾɨkõsɐjtu
preconceito	pɾɨkõsejtu
predela	pɾɨðɛlɐ
prédio	pɾɛðju
preeminência	preeminẽsja
prefeito	pɾɨfɐjtu
prefeito	pɾɨfejtu
prega	pɾɛɣɐ
pregar	pɾɨɣaɾ
pregar	pɾɛɣaɾ
prego	pɾɛɣu
preguiça	pɾɨɣisɐ
preju	pɾeʒu
prejudicar	pɾɨʒuðikaɾ
prejuízo	pɾɨʒuizu
prelado	pɾɨlaðu
premente	pɾemẽtʃi
premiar	pɾɨmjaɾ
prémio	pɾɛmju
prenda	pɾẽdɐ
prender	pɾẽdeɾ
prenhe	pɾeɲɨ
prensa	pɾẽsɐ
preocupação	pɾjɔkupɐsɐ̃w̃
preocupar	pɾjɔkupaɾ
preparação	pɾɨpɐɾɐsɐ̃w̃
preparado	pɾɨpɐɾaðu
preparar	pɾɨpɐɾaɾ
preponderância	pɾɛpõderãsja
prepotência	pɾɛpotẽsja
prepúcio	pɾɨpusjʊ
prepúcios	pɾɨpusjʊʃ
presa	pɾezɐ
prescritível	pɾeskritʃivew
presença	pɾɨzẽsɐ
presente	pɾɨzẽtɨ
presentear	pɾɨzẽtjaɾ
presepada	pɾezepada
presépio	pɾɨzɛpju
preservação	pɾɨzɨɾvɐsɐ̃w̃
presidente	pɾɨzidẽtɨ
preso	pɾezu
pressão	pɾɨsɐ̃w̃
pressionar	pɾɨsjunaɾ
presunto	pɾɨzũtu
preta	pɾetɐ
pretexto	pɾɨtɐjʃtu
pretinho	pɾɨtiɲu
preto	pɾetu
prevenção	pɾɨvẽsɐ̃w̃
previsão	pɾɨvizɐ̃w̃
previsto	pɾɨviʃtu
prima	pɾimɐ
primavera	pɾimɐvɛɾɐ
primaveril	pɾimɐvɨɾiɫ
primeira	pɾimɐjɾɐ
primeiramente	pɾimɐjɾɐmẽtɨ
primeiras	pɾimɐjɾɐʃ
primeiro	pɾimɐjɾu
primeiros	pɾimɐjɾuʃ
primo	pɾimu
primo	pɾimu
princesa	pɾĩsezɐ
principal	pɾĩsipaɫ
principalmente	pɾĩsipaɫmẽtɨ
príncipe	pɾĩsɨpɨ
príncipe	pɾĩsipɨ
princípio	pɾĩsipju
princípios	pɾĩsipjus
principiou	pɾĩsipiow
principiou	-pjow
print	pɾĩtʃi
prisão	pɾizɐ̃w
prisioneiro	pɾizjunɐjɾu
privação	pɾivɐsɐ̃w̃
privado	pɾivadu
privar	pɾivaɾ
privatizar	pɾivɐtizaɾ
pró	pɾɔ
proa	proɐ
probabilidade	pɾuβɐβiliðaðɨ
problema	pɾuβlemɐ
problemático	pɾuβlɨmatiku
problematizar	pɾuβlɨmɐtizaɾ
procedência	pɾusɨðẽsjɐ
processar	pɾusɨsaɾ
processo	pɾusɛsu
procissão	pɾusisɐ̃w̃
próclise	pɾɔklizi
procura	pɾɔkuɾɐ
procurando	pɾɔkuɾɐ̃du
procurar	pɾɔkuɾaɾ
procurava	pɾɔkuɾavɐ
produção	pɾuðusɐ̃w̃
produto	pɾuðutu
produtor	pɾuðutoɾ
produzir	pɾuduziɾ
proeminência	proeminẽsja
proeza	pɾwezɐ
profe	pɾɔfɨ
profecia	pɾufɨsiɐ
professor	pɾufɨsoɾ
profícuo	pɾofikwu
profundamente	pɾufũdɐmẽtɨ
profundidade	pɾufũdiðaðɨ
profundo	pɾufũdu
programador	pɾuɣɾɐmɐðoɾ
progresso	pɾuɣɾɛsu
proibição	pɾuiβisɐ̃w̃
proibição	pɾujβisɐ̃w̃
proibido	pɾuiβiðu
projete	pɾoʒɛtʃi
projeto	pɾuʒɛtu
prólogo	pɾɔluɣu
promessa	pɾumɛsɐ
promete	pɾomɛtʃi
pronome	pɾʊnʊmɨ
pronto	pɾõtu
pronuncia	pɾunũsiɐ
pronunciar	pɾunũsjaɾ
pronunciar	pɾonũsjaʁ
propaganda	pɾupɐɣɐ̃dɐ
proposição	pɾupuzisɐ̃w̃
propósito	pɾupɔzitu
proposta	pɾupɔʃtɐ
própria	pɾɔpɾjɐ
próprias	pɾɔpɾjɐʃ
propriedade	pɾupɾiɛðaðɨ
proprietário	pɾupɾiɛtaɾju
próprio	pɾɔpɾju
próprios	pɾɔpɾjuʃ
prosa	pɾɔzɐ
prostituição	pɾust̪ɪt̪ʊɪsə̃ʊ
prostituições	pɾust̪ɪt̪ʊɪsʊ̃ɪʃ
prostituta	pɾɔʃtitutɐ
proteção	pɾutɛsɐ̃w̃
proteger	pɾutɨʒeɾ
proteína	pɾutiinɐ
protelar	pɾotelaɾ
protelar	pɾotelaχ
protestante	pɾutɨʃtɐ̃tɨ
protestar	pɾutɨʃtaɾ
protesto	pɾutɛʃtu
prova	pɾɔvɐ
provar	pɾuvaɾ
provável	pɾuvavɛɫ
provavelmente	pɾuvavɛɫmẽtɨ
proveito	pɾuvɐjtu
proveito	pɾuvejtu
província	pɾuvĩsjɐ
provinha	pɾuviɲɐ
provocador	pɾuvukɐdoɾ
provocar	pɾuvukaɾ
provocatório	pɾuvukɐtɔɾju
próximo	pɾɔsimu
prudência	pɾuðẽsjɐ
prudente	pɾudẽtɨ
pseudónimo	psewðɔnimu
psicóloga	psikɔloɡa
psicologia	psikoloʒia
psicológico	psikolɔʒiku
psicólogo	psikɔloɡu
psiquiatria	psikiatɾia
pua	puɐ
publicamente	puβlikɐmẽtɨ
publicano	puβlikɐnu
publicar	puβlikaɾ
publicidade	puβlisiðaðɨ
publicitado	puβlisitaðu
publicitar	puβlisitaɾ
público	publiku
púcaro	pukɐɾu
pudera	pudɛɾa
pudesse	puðɛsɨ
pudim	puðĩ
pueril	pwɛɾiɫ
pugnar	puɣɨnaɾ
pulcro	puɫkrʊ
pulga	puɫɣɐ
pulha	puʎɐ
pulôver	pulovɛɾ
púlpito	puɫpitu
pulsação	puɫsɐsɐ̃w̃
pulsar	puɫsaɾ
pulseira	puɫsɐjɾɐ
pulso	puɫsu
puma	pumɐ
punha	puɲɐ
punhal	puɲaɫ
punheta	puɲeta
punhete	puɲɛtʃi
punho	puɲu
punhos	puɲuʃ
pupila	pupilɐ
pureza	puɾezɐ
purga	puɾɣɐ
purificar	puɾifikaɾ
puro	puɾu
pus	puʃ
pus	puʃ
pusestes	puzɛʃtɘʃ
pusilanimidade	puzilãnimidadʒi
puto	putu
puxa	puʃɐ
puxando	puʃɐ̃du
puxar	puʃaɾ
puxou	puʃow
quadra	kwaðɾɐ
quadrado	kwɐðɾaðu
quadro	kwaðɾu
qual	kwaɫ
qualidade	kwɐliðaðɨ
qualquer	kwaɫkɛɾ
quando	kwɐ̃du
quantia	kwɐ̃tiɐ
quantidade	kwɐ̃tiðaðɨ
quanto	kwɐ̃tʊ
quantos	kwɐ̃tuʃ
quão	kwɐ̃w̃
quarenta	kwɐɾẽtɐ
quaresma	kwɐɾɛʒmɐ
quarta	kwaɾtɐ
quarto	kwaɾtu
quartos	kwaɾtuʃ
quase	kwazɨ
quati	kwati
quatro	kwatɾu
quatrocentos	kwatɾusẽtuʃ
que	kɨ
quê	ke
quebra	kɛbɾɐ
quebradeira	kɨβɾɐðɐjɾɐ
quebradiço	kɨβɾɐðisu
quebrado	kɨβɾaðu
quebrar	kɨβɾaɾ
queda	kɛðɐ
queijo	kɐjʒu
queijo	kejʒu
queimadura	kɐjmɐðuɾɐ
queimar	kɐjmaɾ
queimar	kejmaɾ
queirós	kɐjɾɔʃ
queixa	kɐjʃɐ
queixo	kɐjʃu
queixume	kɐjʃum
quelónio	kɨlɔnju
quem	kɐ̃j̃
quente	kẽtɨ
queque	kɛkɨ
quer	kɛɾ
quera	kwɛɾa
querem	kɛɾɐ̃j̃
querendo	kɨɾẽdu
querer	kɨɾeɾ
queres	kɛɾɨʃ
queria	kɨɾiɐ
querido	kɨɾiðu
quero	kɛɾu
querubim	kɨɾuβĩ
questão	kɨʃtɐ̃w̃
questionar	kɨʃtjunaɾ
questionar	kwestʃonaɾ
quiçá	kisa
quieto	kjɛtu
quilha	kiʎɐ
quilo	kilu
quilómetro	kilɔmɨtɾu
quimera	kimɛɾa
química	kimikɐ
químico	kimiku
quina	kinɐ
quinar	kinaɾ
quinhão	kiɲɐ̃w̃
quinhentos	kiɲẽtuʃ
quinta	kĩtɐ
quintal	kĩtaɫ
quinto	kĩtu
quiosque	kjɔʃkɨ
quis	kiʃ
quiser	kizɛɾ
quisto	kistu
quisto	kijʃtu
quitanda	kitãda
quitar	kitaɾ
quite	kitɨ
quitinete	kitʃinɛtʃi
quivi	kivi
quórum	kwɔɾũ
quotidiano	kutiðjɐnu
quotidiano	kɔtiðjɐnu
rã	ʁɐ̃
rabanada	ʁɐβɐnaðɐ
rabino	ʁɐβinu
rabo	ʁabu
raça	ʁasɐ
ração	ʁɐsɐ̃w̃
racha	ʁaʃɐ
racial	ʁɐsjaɫ
racional	ʁɐsjunal
radical	ʁɐðikaɫ
rádio	ʁaðju
râguebi	ʁɐɣɨβi
raia	ʁajɐ
raiano	ʁajɐnu
raiar	ʁajaɾ
rainha	ʁɐiɲɐ
raio	ʁaju
raiva	ʁajvɐ
raiz	ʁɐiʃ
rajada	ʁɐʒaðɐ
ralé	ʁɐlɛ
rali	ʁali
ramagem	ʁɐmaʒɐ̃j̃
ramagens	ʁɐmaʒɐ̃j̃ʃ
ramificação	ʁɐmifikɐsɐ̃w̃
ramo	ʁɐmu
ramos	ʁɐmuʃ
rampa	ʁɐ̃pɐ
ranço	ʁɐ̃su
rancor	ʁɐ̃koɾ
ranger	ʁɐ̃ʒeɾ
rapar	ʁɐpaɾ
rapariga	ʁɐpɐɾiɣɐ
rapaz	ʁɐpaʃ
rapazes	ʁɐpazɨʃ
rapaziada	ʁɐpɐzjaðɐ
rapidamente	ʁapiðɐmẽtɨ
rápido	ʁapiðu
raposa	ʁɐpozɐ
rapto	ʁaptu
raquete	ʁakɛtɨ
raro	ʁaɾu
raspar	ʁɐʃpaɾ
ratazana	ʁɐtɐzɐnɐ
rato	ʁatu
razão	ʁɐzɐ̃w̃
razões	ʁɐzõj̃ʃ
ré	ʁɛ
reação	ʁjasɐ̃w̃
reais	xɨajʃ
real	ʁjaɫ
realçar	ʁjaɫsaɾ
realidade	ʁjɐliðaðɨ
realmente	ʁjaɫmẽtɨ
reator	ʁjatoɾ
rebanho	ʁɨβɐɲu
rebentar	ʁɨβẽtaɾ
rebobinar	ʁɨβuβinaɾ
recado	ʁɨkaðu
recanto	ʁɨkɐ̃tu
recato	ʁɨkatu
recear	ʁɨsjaɾ
receber	ʁɨsɨβeɾ
recebera	ʁɨsɨβeɾɐ
receberá	ʁɨsɨβɨɾa
recebido	ʁɨsɨβiðu
receção	ʁɨsɛsɐ̃w̃
receio	ʁɨsɐju
receita	ʁɨsɐjtɐ
receita	ʁɨsejtɐ
receitar	ʁɨsɐjtaɾ
receoso	ʁɨsjozu
recetor	ʁɨsɛtoɾ
recibo	ʁɨsiβu
reciclar	ʁɨsiklaɾ
recinto	ʁesĩtu
recipiente	ʁɨsipjẽtɨ
recitar	ʁɨsitaɾ
reclinou	ʁeklinow
reco	ʁɛku
recolher	ʁɨkuʎeɾ
recombinação	ʁɨkõbinɐsɐ̃w̃
recompensa	ʁɨkõpẽsɐ
reconhecer	ʁɨkuɲɨseɾ
recordação	ʁɨkuɾðɐsɐ̃w̃
recostou	ʁekostow
recuar	ʁɨkwaɾ
recurso	ʁɨkuɾsu
recusar	ʁɨkuzaɾ
redação	ʁɨðasɐ̃w̃
rede	ʁeðɨ
rédea	ʁɛðjɐ
redenção	ʁɨðẽsɐ̃w̃
redobrar	ʁɨðuβɾaɾ
redondo	ʁɨdõdu
redondo	ʁɨðõdu
redor	ʁɨðɔɾ
redundância	ʁɨðũdɐ̃sjɐ
reduzir	ʁɨðuziɾ
refeição	ʁɨfɐjsɐ̃w̃
refém	ʁɨfɐ̃j̃
refletir	ʁɨflɛtiɾ
reflexão	ʁɨflɛksɐ̃w̃
reflexão	ʁɨflɛsɐ̃w̃
reflexo	ʁɨflɛksu
reforçar	ʁɨfuɾsaɾ
reforço	ʁɨfoɾsu
reforma	ʁɨfɔɾmɐ
reformista	ʁɨfɔɾmiʃtɐ
refrescar	ʁɨfɾɨʃkaɾ
refresco	ʁɨfɾeʃku
regaçar	ʁəɡɐsaɾ
regalo	ʁɨɣalu
regata	ʁɨɡatɐ
regímen	ʁɨʒimɛn
registar	ʁɨʒiʃtaɾ
registo	ʁɨʒiʃtu
regra	ʁɛɣɾɐ
regressar	ʁɨɣɾɨsaɾ
regresso	ʁɨɣɾɛsu
régua	ʁɛɣwɐ
regulamento	ʁɨɣulɐmẽtu
regular	ʁɨɣulaɾ
regularidade	ʁɨɣulɐɾiðaðɨ
rei	ʁɐj
rei	ʁej
reino	ʁɐjnu
reino	ʁejnu
reis	ʁɐjʃ
rejuvenescer	ʁɨʒuvɨnɨʃseɾ
relação	ʁɨlɐsɐ̃w
relacionado	ʁɨlɐsjunaðu
relacionamento	ʁɨlɐsjunɐmẽtu
relacionar	ʁɨlɐsjunaɾ
relações	ʁɨlɐsõj̃ʃ
relâmpago	ʁɨlɐ̃pɐɣu
relance	ʁɨlɐ̃sɨ
relatar	ʁɨlɐtaɾ
relativamente	ʁɨlɐtivɐmẽtɨ
relato	ʁɨlatu
reles	ʁɛlɨʃ
relicário	ʁɨlikaɾju
religião	ʁɨliʒjɐ̃w̃
religiosidade	ʁɨliʒjuziðaðɨ
religioso	ʁɨliʒjozu
relíquia	ʁɨlikjɐ
relógio	ʁɨlɔʒiu
relógio	ʁɨlɔʒju
relojoeiro	ʁɨluʒwɐjɾu
relva	ʁɛɫvɐ
remanejamento	ʁemaneʒamẽtu
remanejar	ʁemaneʒaɾ
remédio	ʁɨmɛðju
remela	ʁɨmɛlɐ
remendo	ʁɨmẽdu
remete	ʁemɛtʃi
remo	ʁemu
remo	ʁɛmu
remoer	ʁɨmweɾ
remoinho	ʁɨmwiɲu
remorso	ʁɨmɔɾsu
remoto	ʁɨmɔtu
remover	ʁɨmuveɾ
rena	ʁenɐ
renda	ʁẽdɐ
rendas	ʁẽdɐʃ
rendição	ʁẽdisɐ̃w̃
renegado	ʁɨnɨɣaðu
renhir	ʁeɲiɹ
renhir	ʁeɲiχ
renhir	reɲiɹ
renhir	reɲiχ
renunciar	ʁɨnũsiaɾ
renunciar	rɨnũsiaɾ
reparação	ʁɨpɐɾɐsɐ̃w̃
reparar	ʁɨpɐɾaɾ
repartição	ʁɨpɐɾtisɐ̃w̃
repartir	ʁɨpɐɾtiɾ
repente	ʀəpẽtə
repetidamente	ʁɨpɨtiðɐmẽtɨ
repetir	ʁɨpɨtiɾ
reportagem	ʁɨpuɾtaʒɐ̃j̃
reportar	ʁɨpuɾtaɾ
repórter	ʁɨpɔɾtɛɾ
repouso	ʁɨpowzu
repreensão	rɨpɾẽsə̃ʊ
repreensões	rɨpɾẽsʊ̃ɪʃ
represa	ʁɨpɾezɐ
represa	ʁɨpɾɛzɐ
representação	ʁɨpɾɨzẽtɐsɐ̃w̃
representando	ʁɨpɾɨzẽtɐ̃du
representante	ʁɨpɾɨzẽtɐ̃tɨ
representar	ʁɨpɾɨzẽtaɾ
representativo	ʁɨpɾɨzẽtɐtivu
reprise	reprizi
reprodução	ʁɨpɾuðusɐ̃w̃
reprodutor	ʁɨpɾuðutoɾ
reproduzir	ʁɨpɾuðuziɾ
república	ʁɛpuβlikɐ
requinte	ʁɨkĩtɨ
resende	ʁɛzẽdɨ
reserva	ʁɨzɛɾvɐ
reset	ʁezɛtʃi
resetar	rezetaɾ
resetar	rezetaχ
resete	ʁezɛtʃi
residência	ʁɨziðẽsjɐ
residente	ʁɨzidẽtɨ
resignação	ʁɨziɡnɐsɐ̃w̃
resignar	ʁɨziɣnaɾ
resina	ʁɨzinɐ
resistência	ʁɨziʃtẽsjɐ
resolução	ʁɨzulusɐ̃w̃
resolver	ʁɨzoɫveɾ
respeitar	ʁɨʃpɐjtaɾ
respeitar	ʁɨʃpejtaɾ
respeitável	ʁɨʃpɐjtavɛɫ
respeito	ʁɨʃpɐjtu
respeitosamente	ʁɨʃpɐjtɔzɐmẽtɨ
respiração	ʁɨʃpiɾɐsɐ̃w̃
respirar	ʁɨʃpiɾaɾ
resplandecente	ʁɨʃplɐ̃dɨsẽtɨ
responder	ʁɨʃpõdeɾ
respondeu	ʁɨʃpõdew
responsabilidade	ʁɨʃpõsɐβiliðaðɨ
responsabilidade	ʁɨʃpõsɐβliðaðɨ
responsável	ʁɨʃpõsavɛɫ
resposta	ʁɨʃpɔʃtɐ
ressarcimento	ʁessaɾsimẽtu
resseção	ʁɨsɛksɐ̃w̃
ressignificar	ʁesiɡnifikaɾ
resto	ʁɛʃtu
resultado	ʁɨzuɫtaðu
resultante	ʁɨzuɫtɐ̃tɨ
resumir	ʁɨzumiɾ
resumo	ʁɨzumu
reta	ʁɛtɐ
retábulo	ʁɨtaβulu
retalho	ʁɨtaʎu
retângulo	retɐ̃ɡulʊ
retardar	ʁɨtɐɾðaɾ
reto	ʁɛtu
retornado	ʁɨtuɾnaðu
retrato	ʁɨtɾatu
retrógrado	ʁɨtɾɔɣɾɐðu
réu	ʁɛw
reunião	ʁjunjɐ̃w̃
reunir	ʁjuniɾ
revelação	ʁɨvɨlɐsɐ̃w̃
revelar	ʁɨvɨlaɾ
revés	ʁɨvɛʃ
revestimento	ʁɨvɨʃtimẽtu
revestir	ʁɨvɨʃtiɾ
revezar	ʁevezaɾ
revezar	ʁevezaχ
revisão	ʁɨvizɐ̃w̃
revista	ʁɨviʃtɐ
revolto	ʁɨvoɫtu
revolução	ʁɨvulusɐ̃w̃
revólver	ʁɯvɔɫvɯɾ
rezar	ʁɨzaɾ
rezende	ʁezẽdʒi
ria	ʁiɐ
ribatejo	ʁiβɐtɛʒu
ribeira	ʁiβɐjɾɐ
ribeiro	ʁibɐjɾu
ribeiro	ʁibɐjɾu
rica	ʁikɐ
ricamente	ʁikɐmẽtɨ
rico	ʁiku
ridiculamente	ʁɨðikulɐmẽtɨ
ridículo	ʁiðikulu
rifa	ʁifɐ
rigidamente	ʁiʒiðɐmẽtɨ
rígido	ʁiʒiðu
rijo	ʁiʒu
rilhar	ʁiʎaɾ
rim	ʁĩ
rindo	ʁĩdu
rinoceronte	ʁinɔsɨɾõtɨ
rio	ʁiu
rio	ʁiu
ripostou	ʁipostow
riqueza	ʁikezɐ
rir	ʁiɾ
risada	ʁizaðɐ
risco	ʁiʃku
riso	ʁizu
risonho	ʁizoɲu
rissol	ʀisɔl
rítmico	ʁitmiku
ritmo	ʁitmu
rito	ʁitu
riu	ʁiw
rivalidade	ʁivɐliðaðɨ
robô	ʀobo
roca	ʁɔkɐ
roça	ʁɔsɐ
roçar	ʁusaɾ
rocha	ʁɔʃɐ
rocim	ʁusĩ
rock	ʁɔk
roda	ʁɔðɐ
rodar	ʁuðaɾ
rodas	ʁɔðɐʃ
rodeado	ʁuðjaðu
rodo	ʁoðu
rodo	ʁɔðu
rodrigo	ʁudɾiɡu
rodrigues	ʁudɾiɡɨʃ
roer	ʁweɾ
roer	ʁueɾ
rogar	ʁuɣaɾ
rola	ʁola
rola	ʁɔla
rolar	ʁulaɾ
rolha	ʁoʎɐ
rolo	ʁolu
rom	ʁõ
romã	ʁumɐ̃
romaji	ʁumɐʒi
romance	ʁumɐ̃sɨ
romano	ʁumɐnu
romântico	ʁumɐ̃tiku
rombo	ʁõbu
rombo	rõbu
roménia	ʁumɛnjɐ
romper	ʁõpeɾ
rompeu	ʁõpew
ronco	ʁõku
ronda	ʁõdɐ
ronrom	ʁõʁõ
ronrono	ʁõʁonu
ronrons	ʁõʁõs
ronrons	ʁõʁõjʃ
rosa	ʁɔzɐ
rosa	ʁɔzɐ
rosácea	ʁuzasjɐ
rosado	ʁuzaðu
rosas	ʁɔzɐʃ
rosca	ʁoska
roseira	ʁuzɐjɾɐ
roseira	ʁuzejɾɐ
rosmaninho	ʁuʒmɐniɲu
rosto	ʁoʃtu
rótula	ʁɔtula
rótulo	ʁɔtulu
rotura	ʁutuɾɐ
roubar	ʁowβaɾ
roubo	ʁowβu
rouco	ʁowku
roupa	ʁowpɐ
roupa	ʁopɐ
roupas	ʁowpɐʃ
rouxinol	ʁowʃinɔɫ
rua	ʁuɐ
ruas	ʁuɐʃ
ruga	ʁuɣɐ
rugir	ʁuʒiɾ
ruído	ʁwiðu
ruim	ʁuĩ
ruim	ruĩ
ruína	ʁuinɐ
ruína	ʁwinɐ
ruivo	ʁujvu
rumo	ʁumu
runa	ʁunɐ
ruptura	ʁuptuɾɐ
russo	ʁusu
rutilância	ʁutʃilãsja
sã	sɐ̃
sábado	saβɐðu
sabão	sɐβɐ̃w̃
sabe	sabɨ
sabedor	sɐβɨðoɾ
sabedoria	sɐβɨðuɾiɐ
sabem	saβɐ̃j̃
sabemos	sɐβemuʃ
sabendo	sɐβẽdu
saber	sɐbeɾ
sabes	saβɨʃ
sabia	sɐβiɐ
sabido	sɐβiðu
sábio	saβiu
sábio	saβju
sabonete	sɐβunetɨ
sabor	sɐboɾ
saborear	sɐbuɾjaɾ
saboroso	sɐβuɾozu
sabre	saβɾɯ̽
sabrosa	sɐβɾɔzɐ
sabugal	sɐβuɣaɫ
sabugo	sɐbuɡu
saca	sakɐ
sacar	sɐkaɾ
sacerdócio	sɐsɨɾðɔsju
sacerdote	sɐsɨɾdɔtɨ
sacho	saʃu
saco	saku
sacola	sɐkɔlɐ
sacramento	sɐkɾɐmẽtu
sacrário	sɐkɾaɾju
sacrifício	sɐkɾifisiu
sacrifício	sɐkɾifisju
sacristia	sakɾiʃtiɐ
sacro	sakɾu
sacrossanto	sakɾusɐ̃tu
sacudir	sɐkuðiɾ
sadio	saðiu
sado	saðu
safa	safɐ
safar	sɐfaɾ
safra	safɾɐ
sagrado	sɐɣɾaðu
sagrar	sɐɣɾaɾ
saguão	saɡwɐ̃w̃
sai	saj
saia	sajɐ
saias	sajɐʃ
saibro	sajβɾu
saída	sɐiðɐ
saído	sɐiðu
saindo	sɐĩdu
saiote	sajɔtʃi
sair	sɐiɾ
sais	sajʃ
saiu	sɐiw
sal	saɫ
sala	salɐ
salada	sɐlaðɐ
salamaleque	sɐlɐmɐlɛkɨ
salamandra	sɐlɐmɐ̃dɾɐ
salão	sɐlɐ̃w̃
salário	sɐlaɾiu
salário	sɐlaɾju
salas	salɐʃ
salazar	sɐlɐzaɾ
salazar	sɐlɐzaɾ
saleta	sɐletɐ
salga	salɣɐ
salgado	saɫɣaðu
salgueiro	saɫɡɐjɾu
salgueiro	saɫɡejɾu
saliva	saliva
salmo	saɫmu
salmoura	saɫmowɾɐ
salsa	saɫsɐ
salsicha	saɫsiʃɐ
saltar	saɫtaɾ
salto	saɫtu
saltou	saɫtow
salva	saɫvɐ
salvação	saɫvɐsɐ̃w̃
salvar	saɫvaɾ
sanar	sɐnaɾ
sanatório	sɐnɐtɔɾju
sanção	sɐ̃sɐ̃w̃
sandália	sɐ̃daljɐ
sandálias	sɐ̃daljɐʃ
sandes	sɐ̃dɨʃ
sandeu	sɐ̃dew
sanduíche	sɐ̃duiʃɨ
sanduíche	sɐ̃dwiʃɨ
saneamento	sɐnjɐmẽtu
sanfona	sɐ̃fonɐ
sangramento	sɐ̃ɡɾɐmẽtu
sangrar	sɐ̃ɡɾaɾ
sangrento	sɐ̃ɡɾẽtu
sangria	sɐ̃ɡɾiɐ
sangue	sɐ̃ɡɨ
sanguento	sɐ̃ɡwẽtu
sanguessuga	sɐ̃ɡɨsuɣɐ
sansão	sɐ̃sɐ̃w̃
santa	sɐ̃tɐ
santana	sɐ̃tɐnɐ
santarém	sɐ̃tɐɾɐ̃j̃
santarém	sɐ̃tɐɾẽj̃
santidade	sɐ̃tiðaðɨ
santo	sɐ̃tu
santos	sɐ̃tuʃ
santos	sɐ̃tuʃ
santuário	sɐ̃tuaɾiu
santuário	sɐ̃tuaɾju
são	sɐ̃w̃
sapateado	sɐpɐtjaðu
sapatilha	sɐpɐtiʎɐ
sapato	sɐpatu
sapatos	sɐpatuʃ
sapo	sapu
saragoça	sɐɾɐɣɔsɐ
saraiva	sɐɾajvɐ
saraiva	sɐɾajvɐ
saraivada	sɐɾajvaðɐ
saraivar	sɐɾajvaɾ
sarar	sɐɾaɾ
sarça	saɾsɐ
sarcasmo	sɐɾkaʒmu
sarcástico	sarkastʃikʊ
sardão	sɐɾðɐ̃w̃
sardinha	sɐɾðiɲɐ
sardoal	sɐɾðuaɫ
sargaço	sɐɾɣasu
sargento	sɐɾʒẽtu
sarilho	sɐɾiʎu
sarrabulho	sɐʁɐβuʎu
sátão	satɐ̃w
satélite	sɐtɛlitɨ
satisfação	sɐtiʃfɐsɐ̃w̃
satisfazer	sɐtiʃfɐzeɾ
satisfeito	sɐtiʃfɐjtu
saturno	sɐtuɾnu
saudação	sɐuðɐsɐ̃w̃
saudação	sɐwðɐsɐ̃w̃
saudade	sawðaðɨ
saudade	sɐwðaðɨ
saudades	sawðaðɨʃ
saudar	sɐuðaɾ
saudar	sɐwðaɾ
saudável	sɐwðavɛɫ
saúde	sɐuðɨ
saxão	saksɐ̃w̃
sazão	sɐzɐ̃w̃
se	sɨ
sé	sɛ
seara	sjaɾɐ
sebastianismo	sɨβɐʃtjɐniʒmu
sebo	seβu
seca	sekɐ
seca	sɛkɐ
secar	sɨkaɾ
secção	sɛksɐ̃w̃
seco	seku
secretamente	sɨkɾɛtɐmẽtɨ
secretaria	sɨkɾɨtɐɾiɐ
secretária	sɨkɾɨtaɾjɐ
secretário	sɨkɾɨtaɾju
secrete	sekɾɛtʃi
secreto	sɨkɾɛtu
sector	sɛktoɾ
século	sɛkulu
séculos	sɛkuluʃ
seda	sedɐ
sede	seðɨ
sede	sɛðɨ
sede	seðɨ
sedoso	sɨðozu
sedução	sɨdʊsə̃ʊ̃
seduções	sɨdʊsʊ̃ɪʃ
seduzir	sɨdʊziɾ
sefardi	sɨfɐɾði
sefardim	sɨfɐɾðĩ
sefardita	sɨfɐɾðitɐ
segar	sɨɣaɾ
segmento	sɨɣɨmẽtu
segredo	sɨɣɾeðu
segregação	sɨɣɾɨɣɐsɐ̃w̃
segue	sɛɣɨ
segue	sɛɡɨ
seguidor	sɨɣiðoɾ
seguinte	sɨɣĩtɨ
seguir	sɨɡiɾ
seguira	sɨɣiɾɐ
seguirá	sɨɣiɾa
segunda	sɨɣũdɐ
segundo	sɨɣũdu
segundos	sɨɣũduʃ
segurança	sɨɣuɾɐ̃sɐ
segurar	sɨɣuɾaɾ
seguridade	sɨɣuɾiðaðɨ
seguro	sɨɣuɾu
seia	sɐjɐ
seio	sɐju
seira	sɐjɾɐ
seis	sɐjʃ
seis	sejʃ
seiscentos	sɐjʃsẽtuʃ
seixal	sɐjʃaɫ
seixo	sɐjʃu
seixo	sejʃu
seja	sɐjʒɐ
seja	seʒɐ
sela	sɛlɐ
seleção	sɨlɛsɐ̃w̃
selecionar	sɨlɛsjunaɾ
selenita	sɨlɨnitɐ
selo	selu
selo	sɛlu
selva	sɛɫvɐ
selvagem	sɛɫvaʒɐ̃j̃
sem	sɐ̃j̃
sem	sẽj̃
semáforo	sɨmafuɾu
semáforos	semafoɾus
semana	sɨmɐnɐ
semanal	sɨmɐnaɫ
semanas	sɨmɐnɐʃ
sêmea	semjɐ
semeador	sɨmjɐðoɾ
semeadura	sɨmjɐðuɾɐ
semear	sɨmjaɾ
semelhança	sɨmɨʎɐ̃sɐ
semelhante	sɨmɨʎɐ̃tɨ
semelhar	sɨmɨʎaɾ
semente	sɨmẽtɨ
sementeira	sɨmẽtɐjɾɐ
semestral	sɨmɨʃtɾaɫ
semestre	sɨmɛʃtɾɨ
semideus	sɨmiðewʃ
seminu	sɨminu
semiólogo	semjɔloɡu
semirreta	sɨmiʁɛtɐ
sémita	sɛmitɐ
sempiterno	sẽpitɛɾnu
sempre	sẽpɾɨ
sena	senɐ
senador	sɨnaðoɾ
senador	senadoʁ
senão	sɨnɐ̃w̃
senciente	sẽsjẽtɨ
senda	sẽdɐ
sendo	sẽdu
senectude	sɨnɛktuðɨ
senha	sɐjɲɐ
senha	seɲɐ
senheiro	sɨɲɐjɾu
senheiro	sɨɲejɾu
senhor	sɨɲoɾ
senhora	sɨɲoɾɐ
senhoras	sɨɲoɾɐʃ
senhores	sɨɲoɾɨʃ
senhoria	sɨɲuɾiɐ
senhorio	sɨɲuɾiu
seno	senu
senra	sẽʁɐ
sensação	sẽsɐsɐ̃w̃
sensato	sẽsatu
sensibilidade	sẽsiβiliðaðɨ
senso	sẽsu
sentada	sẽtaðɐ
sentado	sẽtaðu
sentar	sẽtaɾ
sente	sẽtɨ
sentença	sẽtẽsɐ
sentia	sẽtiɐ
sentido	sẽtiðu
sentimental	sẽtimẽtaɫ
sentimento	sẽtimẽtu
sentindo	sẽtĩdu
sentinela	sẽtinɛlɐ
sentir	sẽtiɾ
sentiu	sẽtiw
sentou	sẽtow
separação	sɨpɐɾɐsɐ̃w̃
separadamente	sɨpɐɾadɐmẽtɨ
separar	sɨpɐɾaɾ
sepultar	sɨpuɫtaɾ
sepultura	sɨpuɫtuɾɐ
sequer	sɨkɛɾ
sequestro	sɨkwɛʃtɾu
sequestro	sɨkɛʃtɾu
ser	seɾ
será	sɨɾa
serão	sɨɾɐ̃w̃
sereia	sɨɾɐjɐ
sereia	sɨɾejɐ
serem	seɾɐ̃j̃
serenidade	sɨɾɨniðaðɨ
seria	sɨɾiɐ
seriamente	sɛɾjɐmẽtɨ
série	sɛɾiɨ
série	sɛɾjɨ
sério	sɛɾiu
sério	sɛɾju
sermão	sɨɾmə̃ʊ
sermões	sɨɾmʊ̃ɪʃ
sernancelhe	sɨɾnɐ̃sɐʎɨ
serpa	sɛɾpɐ
serpe	sɛɾpɨ
serpente	sɨɾpẽtɨ
serra	sɛʁɐ
sertã	sɨɾtɐ̃
sertã	sərtɐ̃
serval	sɨɾvaɫ
serviçal	sɨɾvisaɫ
serviço	sɨɾvisu
servidão	sɨɾviðɐ̃w̃
servir	sɨɾviɾ
servo	sɛɾvu
sesimbra	sɨzĩbɾɐ
sessenta	sɨsẽtɐ
sesta	sɛʃtɐ
sestra	sɛʃtɾɐ
sestro	sɛʃtɾu
set	sɛtʃi
seta	sɛtɐ
setecentos	sɛtɨsẽtuʃ
setembro	sɨtẽbɾu
setenta	sɨtẽtɐ
sétimo	sɛtimu
setor	sɛtoɾ
setor	sɨtoɾ
setúbal	sɨtubaɫ
seu	sew
seus	sewʃ
severas	sɨvɛɾɐʃ
severidade	sɨvɨɾiðaðɨ
severo	sɨvɛɾu
sevilha	sɨviʎɐ
sexo	sɛksu
sexto	sɐjʃtu
sexto	sejʃtu
sexual	sɛkswaɫ
shopping	ʃɔpĩŋ
si	si
sido	siðu
sídon	sidõ
sievert	sivɐɾt
sigilo	siʒilu
significado	siɡnifikaðu
signo	siɡnu
silêncio	silẽsju
silenciosa	silẽsjɔzɐ
silencioso	silẽsjozu
silente	silẽtɘ
silhueta	siʎwetɐ
silva	siɫvɐ
silva	siɫvɐ
silvestre	siɫvɛʃtɾɨ
sim	sĩ
simbolizando	sĩbulizɐ̃du
simbolizar	sĩbulizaɾ
símbolo	sĩbulu
simbologia	sîboloʒia
similar	sɨmilaɾ
simpático	sĩpatiku
simpatizante	sĩpatizɐ̃tɨ
simples	sĩplɨʃ
simplesmente	sĩplɨʒmẽtɨ
simplicidade	sĩplisiðaðɨ
simplificar	sĩplifikaɾ
simulação	simulɐsɐ̃w̃
simulacro	simulakɾu
simum	simũ
sina	sinɐ
sinais	sinajʃ
sinal	sinaɫ
sinalização	sinɐlizɐsɐ̃w
sinalizar	sinɐlizaɾ
sinceramente	sĩsɛɾɐmẽtɨ
sinceridade	sĩsɨɾiðaðɨ
sincero	sĩsɛɾu
sindical	sĩdikaɫ
sindicato	sĩdikatu
sineiro	sinɐjɾu
sineiro	sinejɾu
sines	sinɨʃ
sineta	sinetɐ
sinfonia	sĩfuniɐ
sinfonista	sĩfuniʃtɐ
singrar	sĩɡɾaɾ
sinistro	siniʃtɾu
sino	sinu
sinó	sinɔ
sinopse	sinɔpsi
sintaxe	sĩtasi
síntese	sĩtɨzɨ
sinto	sĩtu
sintoma	sĩtomɐ
sintonia	sĩtuniɐ
sintra	sĩtɾɐ
sirena	siɾenɐ
sirgo	siɾɣu
sismo	siʒmu
siso	sizu
sistema	siʃtemɐ
sistematizar	siʃtɨmɐtizaɾ
sítio	sitju
situação	sitwɐsɐ̃w̃
só	sɔ
soalheiro	swɐʎɐjɾu
soalheiro	swɐʎejɾu
soalho	swaʎu
soar	suaɾ
soar	swaɾ
sob	sob
sobe	sɔβɨ
sobejo	suβɐʒu
sobejo	suβɐjʒu
sobejo	suβeʒu
sobejo	suβejʒu
soberania	suβɨɾɐniɐ
sobra	sɔβɾɐ
sobrancelha	subɾɐ̃seʎɐ
sobrar	suβɾaɾ
sobre	sobɾɨ
sobre	sɔbɾɨ
sobrecasaca	soβɾɨkɐzakɐ
sobremesa	soβɾɨmezɐ
sobretudo	soβɾɨtuðu
sobreviver	soβɾɨviveɾ
sobrinha	suβɾiɲɐ
sobrinho	suβɾiɲu
sóbrio	sɔbɾiu
sóbrio	sɔbɾju
sociabilidade	sosjabilidadʒi
social	susjaɫ
socialismo	susjaliʒmu
sociedade	susjɐðaðɨ
socorro	sukoʁu
soer	sweɾ
sofá	sufa
sôfrego	sofɾɨɣu
sofreguidão	sofɾɨɣiðɐ̃w̃
sofrer	sufɾeɾ
sofrimento	sufɾimẽtu
sogra	sɔɣɾɐ
sois	sojʃ
soito	sojtu
sol	sɔɫ
sol	sɔɫ
solar	sulaɾ
soldado	soɫdaðu
soldado	sɔɫdaðu
soleira	sulɐjɾɐ
soleira	sulejɾɐ
solidão	suliðɐ̃w̃
solidéu	sɔliðɛw
solidez	suliðeʃ
solidificação	suliðifikɐsɐ̃w̃
solidificar	suliðifikaɾ
sólio	sɔli̯u
solitário	sulitaɾju
solo	sɔlu
sologamia	sɔloɡɐ̃mia
soltar	soɫtaɾ
solteiro	soɫtɐjɾu
solto	soɫtu
solução	sulusɐ̃w̃
soluçar	sulusaɾ
soluço	sulusu
som	sõ
soma	somɐ
soma	somɐ
soma	sɔmɐ
soma	sɔmɐ
sombra	sõbɾɐ
sombras	sõbɾɐʃ
sombreiro	sõbɾɐjɾu
sombreiro	sõbɾejɾu
sombrinha	sõbɾiɲɐ
sombrio	sõbɾiu
somente	sɔmẽtɨ
somos	somuʃ
sonda	sõdɐ
sonhador	suɲɐðoɾ
sonhar	suɲaɾ
sonho	soɲu
sonhos	soɲuʃ
sono	sonu
sonolento	sunulẽtu
soo	sou
sopa	sopɐ
sopesar	sopezaɾ
sopesar	sopezaʁ
soprar	supɾaɾ
sopro	sopɾu
sopro	sɔpɾu
soro	soɾu
soro	sɔɾu
soror	surɔr
sóror	sɔrɔr
sorria	suʁiɐ
sorridente	suʁiðẽtɨ
sorrindo	suʁĩdu
sorrir	suʁiɾ
sorriso	suʁizu
sorriu	suʁiw
sorte	sɔɾtɨ
sorumbático	suɾũbatiku
sós	sɔʃ
sósia	sɔzjɐ
sossegado	susɨɣaðu
sossegar	susɨɣaɾ
sossego	suseɣu
sossego	susɛɣu
sotaina	sotajna
sótão	sɔtɐ̃w
sotaque	sutakɨ
sou	sow
soube	sowβɨ
soure	sowɾɨ
sousa	sowzɐ
sousel	sowzɛɫ
souto	sowtu
sozinho	sɔziɲu
style	istajli
style	stajli
style	iʃtajli
sua	suɐ
suaíli	suaili
suaíli	swaili
suar	suaɾ
suar	swaɾ
suas	suɐʃ
suave	swavɨ
suavidade	swɐviðaðɨ
suba	suβɐ
subclínico	subkliniku
subdivisão	suβɨðɨvizɐ̃w̃
subindo	suβĩdu
subir	suβiɾ
subitamente	suβitɐmẽtɨ
súbito	suβitu
subiu	suβiw
subjetivamente	subʒɛtivɐmẽtɨ
subjetivo	subʒɛtivu
sublevação	suβlɨvɐsɐ̃w̃
sublimação	suβlimɐsɐ̃w̃
sublimar	suβlimaɾ
sublime	sublimɨ
submete	submɛtʃi
substância	subʃtɐ̃sjɐ
substancial	subʃtɐ̃sjaɫ
substantivo	subʃtɐ̃tivu
subterfúgio	subterfuʒju
subúrbio	suβuɾβju
subversão	suβɨvɨɾsɐ̃w̃
subversivo	suβɨvɨɾsivu
suceder	susɨðeɾ
sucedido	susɨðiðu
sucessão	susɨsɐ̃w̃
sucesso	susɛsu
sucinto	susĩtu
sucumbir	sukũbiɾ
sudeste	suðɛʃtɨ
sudoeste	suðwɛʃtɨ
suécia	swɛsjɐ
sueco	suɛku
sueco	swɛku
suficiente	sufisjẽtɨ
suficiente	sufɨsjẽtɨ
suficientemente	sufisjẽtɨmẽtɨ
sufocado	sufukaðu
sufocar	sufukaɾ
sugerir	suʒɨɾiɾ
sugestão	suʒɨʃtɐ̃w̃
sugestivo	suʒɨʃtivu
suíço	suisu
sujar	suʒaɾ
sujeito	suʒɐjtu
sujeitos	suʒɐjtuʃ
sujo	suʒu
sul	suɫ
sultão	suɫtɐ̃w̃
sumir	sumiɾ
sumo	sumu
suor	suɔɾ
superar	supɨɾaɾ
superávit	superavitʃi
superavitário	superavitarju
superfície	supɨɾfisjɨ
superfície	supɨɾfisji
superior	supɨɾjoɾ
superioridade	supɨɾjuɾiðaðɨ
supermercado	supɛɾmɨɾkadu
superstição	supɨɾʃtisɐ̃w̃
supersticioso	supɨɾʃtisjozu
superveniência	supeɾveniẽsja
supervisor	supɛɾvizoɾ
súplica	suplikɐ
supor	supoɾ
suportar	supuɾtaɾ
suportável	supuɾtavɛɫ
suporte	supɔɾtɨ
suposição	supuzisɐ̃w̃
supostamente	supoʃtɐmẽtɨ
supremacia	supɾɨmɐsiɐ
supremo	supɾemu
suprir	supɾiɾ
surdo	suɾðu
surpreender	suɾpɾjẽdeɾ
surpreendido	suɾpɾjẽdiðu
surpresa	suɾpɾezɐ
surpreso	suɾpɾezu
surrão	suʁɐ̃w̃
susana	suzɐnɐ
suspeita	suʃpɐjtɐ
suspenso	suʃpẽsu
suspirar	suʃpiɾaɾ
suspiro	suʃpiɾu
sussurro	susuʁu
sustentação	suʃtẽtɐsɐ̃w̃
sustentar	suʃtẽtaɾ
suster	suʃteɾ
susto	suʃtu
sutiã	sutjɐ̃
tá	ta
tabaco	tɐβaku
tabefe	tabɛfi
tabela	tɐβɛlɐ
taberna	tɐβɛɾnɐ
tablete	tablɛtʃi
taboca	tabɔka
tábua	taβwɐ
tábua	taβuɐ
tabuaço	tɐβuasu
tabuada	tɐβwaðɐ
tabular	tabular
tabuleiro	tɐβulɐjɾu
taça	tasɐ
tacha	taʃɐ
tácito	tasitu
taco	taku
tael	tɐɛɫ
taful	tɐfuɫ
tagarela	tɐɣɐɾɛlɐ
tágide	taʒiðɨ
tais	tajʃ
taiwan	tajwɐ̃
tal	taɫ
talento	tɐlẽtu
talhar	tɐʎaɾ
talher	taʎɛɾ
talher	taʎɛʁ
talho	taʎu
tálus	talus
talvez	taɫveʃ
tamanho	tɐmɐɲu
tâmara	tɐmɐɾɐ
também	tɐ̃bɐ̃j̃
também	tɐ̃bẽj̃
tambor	tɐ̃boɾ
tamborete	tãbuɾetɨ
tamborilar	tɐ̃borilaɾ
tamém	tɐmẽj̃
tampouco	tɐ̃w̃powku
tangente	tɐ̃ʒẽtɨ
tangerina	tɐ̃ʒɨɾinɐ
tango	tɐ̃ɡu
tanque	tɐ̃kɨ
tanso	tɐ̃su
tantã	tɐ̃tã
tântalo	tɐ̃talu
tanto	tɐ̃tu
tantos	tɐ̃tuʃ
tanuki	tɐnuki
tão	tɐ̃w̃
tapeçaria	tɐpɨsɐɾiɐ
tapete	tɐpetɨ
tapir	tapiɾ
taquara	takwaɾa
tar	taɾ
tarde	taɾðɨ
tardio	tɐɾðiu
tareco	tarɛku
tarefa	tɐɾɛfɐ
tarouca	tɐɾowkɐ
tarrafa	taʁafa
tarraxa	tɐʁaʃɐ
tarraxar	tɐʁɐʃaɾ
tasca	taʃkɐ
tática	tatikɐ
tático	tatiku
tato	tatu
tavira	tɐviɾɐ
taxa	taʃɐ
taxar	tɐʃaɾ
tchau	t͡ʃaw
tchê	t͡ʃe
te	tɨ
tê	te
teatro	tjatɾu
tecei	tɘsɐj
tecer	tɨseɾ
tecla	tɛklɐ
teclado	tɛklaðu
teco	tɛku
tédio	tɛðju
teia	tɐjɐ
teia	tejɐ
teias	tɐjɐʃ
teias	tejɐʃ
teima	tɐjmɐ
teima	tejmɐ
teimar	tɐjmaɾ
teimar	tejmaɾ
teixeira	tɐjʃɐjɾɐ
teixeira	tejʃejɾɐ
teixo	tɐjʃu
teixo	tejʃu
tejo	tɛʒu
tela	tɛlɐ
telecomando	tɛlɛkumɐ̃du
teledramaturgia	tɛledɾamatuɾʒia
teledramaturgia	tɛledɾamatuʁʒia
telefone	tɨlɨfɔnɨ
telemóvel	tɛlɛmɔvɛɫ
telha	teʎɐ
telha	tɐʎɐ
telha	tɐjʎɐ
telhado	tɨʎaðu
telhar	tɨʎaɾ
tem	tɐ̃j̃
têm	tɐ̃jɐ̃j
têm	tẽj̃
temer	tɨmeɾ
temor	tɨmoɾ
temos	temuʃ
tempera	tẽpɛɾa
temperamento	tẽpɨɾɐmẽtu
temperatura	tẽpɨɾɐtuɾɐ
tempero	tẽperu
templo	tẽplu
temporal	tẽpuɾaɫ
temporão	tẽpoɾɐ̃w̃
tempos	tẽpuʃ
tempurá	tẽpuɾa
tença	tẽsa
tenção	tẽsɐ̃w̃
tenda	tẽdɐ
tendência	tẽdẽsjɐ
tender	tẽdeɾ
tendo	tẽdu
tenebroso	tɨnɨβɾozu
tenência	tenẽsja
tenente	tɨnẽtɨ
tenha	tɐjɲɐ
tenha	teɲɐ
tenho	tɐɲu
tenho	teɲu
ténis	tɛniʃ
tenro	tẽʁu
tens	tɐ̃j̃ʃ
tensão	tẽsɐ̃w̃
tenso	tẽsu
tentação	tẽtɐsɐ̃w̃
tentações	tɪ̃təsʊ̃ɪʃ
tentador	tɛ̃tadoɾ
tentar	tẽtaɾ
tentativa	tẽtɐtivɐ
ténue	tɛnwɨ
teoria	tjuɾiɐ
teórico	tjɔɾiku
tépido	tɛpiðu
ter	teɾ
tera	tɛra
terá	tɨɾa
terabit	tɛɾabit͡ʃi
terabit	tɛɾabiti
terabyte	tɛɾabajtʃi
terceiro	tɨɾsɐjɾu
terceiro	tɨɾsejɾu
terço	teɾsu
terem	teɾɐ̃j̃
tereré	teɾeɾɛ
tererê	teɾeɾe
tergiversação	teɾʒiveɾsasɐ̃w̃
tergiversar	teɾʒiveɾsar
teria	tɨɾiɐ
terminar	tɨɾminaɾ
término	tɛɾminu
terminou	tɨɾminow
termo	teɾmu
ternamente	tɛɾnɐmẽtɨ
terno	tɛɾnu
ternura	tɨɾnuɾɐ
terra	tɛʁɐ
terra	tɛʁɐ
terráqueo	tɨʁakju
terras	tɛʁɐʃ
terreiro	tɨʁɐjɾu
territorial	tɨʁituɾjaɫ
território	tɨʁitɔɾju
terrível	tɨʁivɛɫ
terrivelmente	tɨʁivɛɫmẽtɨ
terror	tɨʁoɾ
tese	tɛzɨ
tesoura	tɨzowɾɐ
tesouro	tɨzowɾu
testa	tɛʃtɐ
testamento	tɨʃtɐmẽtu
testar	tɨʃtaɾ
testar	tɨʃtaɾ
testar	tɨʃtaɾ
teste	tɛʃtɨ
teste	tɛʃtɨ
testemunha	tɨʃtɨmuɲɐ
testemunhar	tɨʃtɨmuɲaɾ
testemunho	tɨʃtɨmuɲu
testículo	tɨʃtikuɫu
teto	tɛtu
tétrico	tɛtɾiku
teu	teu̯
teu	tew
teus	tɛu̯ʃ
teutónico	tewtɔniku
teve	tevɨ
têxtil	tɐjʃtiɫ
texto	tɐjʃtu
texugo	tɨʃuɣu
tez	teʃ
ti	ti
tia	tiɐ
tiago	tiaɣu
tíbia	tiβjɐ
tição	tisɐ̃w̃
tigela	tiʒɛlɐ
tigre	tiɣɾɨ
tijolo	tiʒolu
til	tiɫ
tímida	timiðɐ
timidez	timiðeʃ
tímido	timiðu
tingir	tĩʒiɾ
tingitano	tĩʒitɐnu
tinha	tiɲɐ
tinham	tiɲɐ̃w̃
tinhoso	tij̃ozu
tinta	tĩtɐ
tinteiro	tĩtɐjɾu
tintim	tĩtĩ
tinto	tĩtu
tio	tiu
tipo	tipu
tira	tiɾɐ
tirando	tiɾɐ̃du
tirano	tiɾɐnu
tirar	tiɾaɾ
tiro	tiɾu
tiros	tiɾuʃ
tirou	tiɾow
tísica	tizikɐ
tísico	tiziku
título	titulu
tive	tivɨ
tiver	tivɛɾ
tivera	tivɛɾɐ
tivesse	tivɛsɨ
tó	tɔ
toa	toɐ
toalha	twaʎɐ
toca	tɔkɐ
tocando	tukɐ̃du
tocar	tukaɾ
tocara	tukaɾɐ
tocará	tukɐɾa
tocava	tukavɐ
tocha	tɔʃɐ
tocou	tukow
toda	toðɐ
toda	tɔðɐ
toda	tɔðɐ
todavia	toðɐviɐ
todo	toðu
todos	toðuʃ
togliatti	tuʎati
toilette	toalɛtʃi
toirada	tojɾaðɐ
toiro	tojɾu
tolerar	tulɨɾaɾ
tolete	tuletɨ
tolice	tulisɨ
tolo	tolu
tom	tõ
toma	tɔmɐ
tomada	tumaðɐ
tomado	tumaðu
tomando	tumɐ̃du
tomar	tumaɾ
tomar	tumaɾ
tomara	tumaɾɐ
tomas	tɔmɐʃ
tomate	tumatɨ
tomateiro	tumɐtɐjɾu
tomava	tumavɐ
tome	tɔmɨ
tomou	tumow
tondela	tõdɛlɐ
tonel	tunɛɫ
tonfa	tõfa
tons	tõʃ
tonto	tõtu
tontura	tõtuɾa
tope	tɔpɨ
topo	topu
toque	tɔkə
toranja	turɐ̃ʒɐ
tórax	tɔɾaks
tordo	toɾdu
tormenta	tuɾmẽtɐ
torna	tɔɾnɐ
tornando	tuɾnɐ̃du
tornar	tuɾnaɾ
tornara	tuɾnaɾɐ
tornará	tuɾnɐɾa
tornaria	tuɾnɐɾiɐ
tornasse	tuɾnasɨ
tornava	tuɾnavɐ
torneira	tuɾnɐjɾɐ
torno	tɔɾnu
tornou	tuɾnow
tornozelo	tuɾnuzelu
toro	tɔɾu
torpe	toɾpi
torpe	tɔɾpi
torrada	tuʁaðɐ
torre	toʁɨ
torre	tɔʁɨ
torrente	tuʁẽtɨ
torres	toʁɨʃ
torta	tɔɾtɐ
torto	toɾtu
tortura	tuɾtuɾa
torturar	tuɾtuɾaɾ
tosse	tɔsɨ
tossir	tusiɾ
tostão	tuʃtɐ̃w̃
totais	totajs
totais	totajʃ
total	tutaɫ
totalidade	tutɐliðaðɨ
toucinho	towsiɲu
toupeira	towpɐjɾɐ
toupeira	towpejɾɐ
tourada	towɾaðɐ
tóxico	tɔksiku
trabalhador	tɾɐβɐʎɐðoɾ
trabalhar	tɾɐβɐʎaɾ
trabalho	tɾɐβaʎu
trabalhos	tɾɐβaʎuʃ
trabalhoso	tɾɐβɐʎozu
trabuco	tɾabuku
traça	tɾasɐ
traçar	tɾɐsaɾ
traço	tɾasu
tradição	tɾɐðisɐ̃w̃
tradicionalmente	tɾɐðisjunaɫmẽtɨ
tradutor	tɾɐðutoɾ
trafalgar	tɾɐfɐlɣaɾ
trágico	traʒiku
traição	tɾajsɐ̃w̃
traição	tɾaisɐ̃w̃
traição	tɾajsɐ̃w̃
traído	tɾɐiðu
traidor	tɾajðoɾ
trair	tɾɐiɾ
traíra	tɾɐiɾɐ
trajar	tɾɐʒaɾ
traje	tɾaʒɨ
traje	tɾaʒi
traje	tɾaʒe
trajeto	tɾɐʒɛtu
trajo	tɾaʒu
trama	tɾɐmɐ
tramar	tɾɐmaɾ
trambicagem	tɾãbikaʒẽ
trambicar	tɾãbikaɾ
trambicar	tɾãbikaχ
trambique	tɾãbiki
trambiqueiro	tɾãbikejɾu
trampolim	tɾɐ̃pulĩ
trampolim	tɾɐ̃polĩ
tranca	tɾɐ̃kɐ
trança	tɾɐ̃sa
trançar	tɾɐ̃saɾ
trancoso	tɾɐ̃kozu
tranquilamente	tɾɐ̃kwilɐmẽtɨ
tranquilidade	tɾɐ̃kwiliðaðɨ
tranquilo	tɾɐ̃kwilu
transa	tɾɐ̃za
transação	tɾɐ̃zasɐ̃w̃
transcendência	trãŋsedẽsja
transeuntes	tɾɐ̃zeũt͡ʃis
transfretano	tɾɐ̃ʃfɾɨtɐnu
transição	tɾɐ̃zisɐ̃w̃
trânsito	tɾɐ̃zitu
transitório	tɾɐ̃zitɔɾiu
transitório	tɾɐ̃zitɔɾju
transparente	tɾɐ̃ʃpɐɾẽtɨ
transportar	tɾɐ̃ʃpuɾtaɾ
transporte	tɾɐ̃ʃpɔɾtɨ
trapaça	tɾɐpasɐ
trapézio	tɾɐpɛzju
trapo	tɾapu
traquejar	tɾakeʒaɹ
traquejar	tɾakeʒaχ
traquejo	tɾakeʒu
trasgo	tɾaʒɡu
trata	tɾatɐ
tratado	tɾɐtaðu
tratamento	tɾɐtɐmẽtu
tratar	tɾɐtaɾ
tratava	tɾɐtavɐ
trato	tɾatu
trator	tɾatoɾ
travando	tɾɐvɐ̃du
travão	tɾɐvɐ̃w̃
travar	tɾɐvaɾ
trave	tɾavɨ
traveco	tɾavɛku
travessa	tɾɐvɛsɐ
travesseiro	tɾɐvɨsɐjɾu
travesseiro	tɾɐvɨsejɾu
travessia	tɾɐvɨsiɐ
travou	tɾɐvow
traz	tɾaʃ
trazem	tɾazɐ̃j̃
trazendo	tɾɐzẽdu
trazer	tɾɐzeɾ
trazia	tɾɐziɐ
trazido	tɾɐziðu
treco	tɾɛku
treinamento	tɾɐjnɐmẽtu
trema	tɾemɐ
trema	tɾemɐ
tremendo	tɾɨmẽdu
tremer	tɾɨmeɾ
tremia	tɾɨmiɐ
tremoço	tɾɨmosu
tremor	tɾɨmoɾ
trémulo	tɾɛmulu
tremura	tɾemuɾa
trena	tɾenɐ
treno	tɾenu
trenó	tɾenɔ
trepar	tɾɨpaɾ
três	tɾeʃ
trete	tɾɛtʃi
treva	tɾɛvɐ
trevas	tɾɛvɐʃ
trevo	tɾevu
trevoso	tɾɨvozu
treze	tɾezɨ
trezentos	tɾɨzẽtuʃ
triangular	tɾiɐ̃ɡulaɾ
triângulo	tɾiɐ̃ɡulu
tribo	tɾibu
tribunal	tɾiβunaɫ
tributo	tɾiβutu
tricô	tɾiko
trigésimo	tɾiʒɛzimu
trigo	tɾiɣu
trilho	tɾiʎu
trimestral	tɾimɨʃtɾaɫ
trincar	tɾĩkaɾ
trindade	tɾĩdadɨ
trindade	tɾĩdadɨ
trinta	tɾĩtɐ
tripa	tɾipɐ
tripeiro	tɾipɐjɾu
tripeiro	tɾipejɾu
tríptico	tɾiptiku
trisavó	tɾizɐvɔ
trisavô	tɾizɐvo
triscar	tɾiʃkaɾ
triste	tɾiʃtɨ
tristemente	tɾiʃtɨmẽtɨ
tristes	tɾiʃtɨʃ
tristeza	tɾiʃtezɐ
tristonha	tɾiʃtoɲɐ
tristonho	tɾiʃtoɲu
tritura	tɾituɾa
triturado	tɾituɾaðu
triturar	tɾituɾaɾ
triunfal	tɾjũfaɫ
triunfante	tɾiũfɐ̃tɨ
triunfo	tɾiũfu
trivial	tɾivjaɫ
trivialidade	trivialidadʒi
troca	tɾɔkɐ
trocadilho	tɾukɐðiʎu
trocador	tɾukɐðoɾ
trocar	tɾukaɾ
troco	tɾoku
troco	tɾɔku
trofa	tɾɔfɐ
trom	tɾõ
tromba	tɾõbɐ
trombeta	tɾõbetɐ
trombone	tɾõbɔnɨ
tronco	tɾõku
troncos	tɾõkuʃ
trono	tɾonu
tropa	tɾɔpɐ
tropelia	tɾupɨliɐ
tropical	tɾupikaɫ
trotskismo	tɾɔtskiʒmu
trouxe	tɾowsɨ
trouxera	tɾowsɛɾɐ
trova	trɔvɐ
trovador	tɾuvɐðoɾ
trovão	tɾuvɐ̃w̃
trovar	truvar
trovejar	tɾuvɨʒaɾ
trovoada	tɾuvwaðɐ
trovoar	tɾuvwaɾ
trufa	tɾufɐ
tsc	ǀ
tsunami	t͡sunɐmi
tu	tu
tua	tuɐ
tuas	tuɐʃ
tubarão	tuβɐɾɐ̃w̃
tubo	tuβu
tucano	tukɐnu
tucuxi	tukuʃi
tudo	tuðu
tufão	tufɐ̃w̃
tufo	tufu
tuiuiú	tujuju
tulipa	tulipɐ
túlipa	tulipɐ
tumefação	tumefasɐ̃w̃
tumor	tumoɾ
túmulo	tumulu
tumulto	tumuɫtu
túnel	tunɛɫ
tupi	tupi
tupiniquim	tupinikĩ
turba	tuɾβɐ
turbulento	tuɾβulẽtu
turno	tuɾnu
turra	tuʁɐ
turu	tuɾu
turvo	tuɾvu
tussa	tusɐ
tutela	tutɛlɐ
tutelar	tutɨlaɾ
u	u
ú	u
ü	w
ü	i
uai	waj
uau	uaw
uau	waw
ubre	ubɾi
ucrânia	ukɾɐnjɐ
ucraniano	ukɾɐniɐnu
ucraniano	ukɾɐnjɐnu
ufa	ufɐ
ufo	ufo
ufólogo	ufɔluɣu
uhul	uʁuw
uísque	wiʃkɨ
uísque	wiʃki
uivar	ujvaɾ
uivo	ujvu
ulterior	uɫtɨɾjoɾ
última	uɫtimɐ
ultimamente	uɫtimɐmẽtɨ
ultimar	uɫtimaɾ
últimas	uɫtimɐʃ
último	uɫtimu
últimos	uɫtimuʃ
ultramar	uɫtɾɐmaɾ
ultrapassar	uɫtɾɐpɐsaɾ
ultrassom	uɫtɾɐsõ
ultrassónico	uɫtɾɐsɔniku
uma	umɐ
umas	umɐʃ
umbigada	ũbiɡadɐ
umbigo	ũbiɣu
umbral	ũbɾaɫ
úmero	umɨɾu
úmido	umiðu
unção	ũsɐ̃w̃
underline	ɐ̃deɾlajni
ungido	ũʒiðu
ungir	ũʒiɾ
unha	uɲɐ
unhar	uɲaɾ
unhas	uɲɐʃ
união	unjɐ̃w̃
única	unikɐ
unicamente	unikɐmẽtɨ
único	uniku
unidade	uniðaðɨ
unido	uniðu
unificação	unifikɐsɐ̃w̃
unificar	unifikaɾ
uniforme	unifɔɾmɨ
unilateralismo	unilateɾalismu
unilateralismo	unilateɾalijʃmu
unir	uniɾ
uníssono	unisunu
universal	univɨɾsaɫ
universidades	universidadʒis
universo	univɛɾsu
uno	unu
uns	ũʃ
untar	ũtaɾ
unto	ũtu
urano	uɾɐnu
urbano	uɾβɐnu
urdir	uɾðiɾ
uretra	uɾɛtɾɐ
urgente	uɾʒẽtɨ
urna	uɾnɐ
uro	uɾu
urrar	uʁaɾ
urrar	uʁaχ
urro	uʁu
urso	uɾsu
uruguai	uɾuɡwaj
uruguaio	uɾuɡwaju
urutau	uɾutaw
urze	uɾzɨ
usa	uzɐ
usado	uzaðu
usar	uzaɾ
uso	uzu
usso	usu
usual	uzwaɫ
usuário	uzuaɾiu
usuário	uzuaɾju
usufruto	uzufɾutu
usura	uzuɾa
usurpação	uzuɾpɐsɐ̃w̃
usurpar	uzuɾpaɾ
útil	utiɫ
útil	utiɫ
utilização	utilizɐsɐ̃w̃
utilizar	utilizaɾ
utópico	utɔpiku
uva	uvɐ
vá	va
vã	vɐ̃
vaca	vakɐ
vacante	vɐkɐ̃tɨ
vácuo	vakuo
vácuo	vakwo
vadio	vaðiu
vadoso	vɐðozu
vaga	vaɣɐ
vagabundagem	vaɡabũdaʒẽj̃
vagabundo	vɐɣɐβũdu
vagamente	vaɣɐmẽtɨ
vagante	vɐɣɐ̃tɨ
vagar	vɐɣaɾ
vagarosamente	vɐɣɐɾɔzɐmẽtɨ
vagaroso	vɐɣɐɾozu
vaginalmente	vɐʒinalmẽtɨ
vaginalmente	vɐʒinalmẽtɨ
vago	vaɣu
vagos	vaɣuʃ
vai	vaj
vaidade	vajðaðɨ
vaidoso	vajðozu
vais	vajʃ
vale	valɨ
valença	vɐlẽsɐ
valente	vɐlẽtɨ
valer	vɐleɾ
vales	valɨʃ
valete	valɛtɨ
valeu	vɐlew
valo	valu
valongo	vɐlõɡu
valor	vɐloɾ
valorizar	vɐluɾizaɾ
valpaços	vaɫpasuʃ
valsa	vaɫsɐ
vamos	vɐmuʃ
vampiro	vɐ̃piɾu
vantajoso	vɐ̃tɐʒozu
vão	vɐ̃w̃
vapor	vɐpoɾ
vaqueiro	vɐkɐjɾu
vara	vaɾɐ
varanda	vɐɾɐ̃dɐ
varandas	vɐɾɐ̃dɐʃ
varão	vɐɾɐ̃w̃
varapau	vaɾapaw
variar	vɐɾiaɾ
variar	vɐɾjaɾ
várias	vaɾjɐʃ
variedade	vɐɾjɛðaðɨ
vário	vaɾju
vários	vaɾjuʃ
vaso	vazu
vasos	vazuʃ
vassalo	vɐsalu
vassoura	vɐsowɾɐ
vasta	vaʃtɐ
vastidão	vɐʃtiðɐ̃w̃
vasto	vaʃtu
vatapá	vatapa
vaticano	vɐtikɐnu
vaticano	vɐtikanu
vau	vaw
vazamento	vɐzɐmẽtu
vazar	vɐzaɾ
vazias	vɐziɐʃ
vazio	vɐziu
vê	ve
veado	vjaðu
vede	veðɨ
vede	vɛðɨ
vegetal	vɨʒɨtaɫ
vegete	veʒɛtʃi
veia	vɐjɐ
veias	vɐjɐʃ
veículo	veikulu
veio	vɐju
veio	veju
veio	vɐju
veio	veju
veja	vɐjʒɐ
veja	veʒɐ
vejo	vɐjʒu
vela	vɛlɐ
velar	vɨlaɾ
velas	vɛlɐʃ
velas	vɛlɐʃ
veleiro	vɨlɐjɾu
velejar	vɨlɨʒaɾ
velha	vɛʎɐ
velhaco	vɨʎaku
velhas	vɛʎɐʃ
velhice	vɨʎisɨ
velho	vɛʎu
velhos	vɛʎuʃ
velocidade	vɨlusiðaðɨ
velocidades	velosidad͡ʒis
veludo	vɨluðu
veludos	vɨluðuʃ
vem	vɐ̃j̃
vêm	vɐ̃j̃ɐ̃j̃
vêm	vẽj̃ẽj̃
vemos	vemuʃ
vencelho	vẽseʎu
vencer	vẽseɾ
vencido	vẽsiðu
vencilho	vẽsiʎu
vencimento	vẽsimẽtu
venda	vẽdɐ
vendar	vẽdaɾ
vendas	vẽdɐʃ
vendaval	vẽdɐvaɫ
vender	vẽdeɾ
veneno	vɨnenu
venenoso	vɨnɨnozu
venera	venɛɾa
veneração	vɨnɨɾɐsɐ̃w̃
venerável	vɨnɨɾavɛɫ
venha	vɐjɲɐ
venha	veɲɐ
venhas	veɲɐʃ
venhas	vɐɲɐʃ
venhas	vɐjɲɐʃ
venho	veɲu
venho	vɐjɲu
venial	vɨnjaɫ
venoso	vɨnozu
vens	vẽʃ
venta	vẽtɐ
ventã	vẽtɐ̃
ventana	vẽtɐnɐ
ventar	vẽtaɾ
vento	vẽtu
ventoinha	vẽtwiɲɐ
ventos	vẽtuʃ
ventoso	vẽtozu
ventre	vẽtɾɨ
ventura	vẽtuɾɐ
vénus	vɛnuʃ
ver	veɾ
verá	vɨɾa
verás	vɨɾaʃ
verbasco	vɨɾβaʃku
verbo	vɛɾβu
verborragia	vɛɹboʁaʒia
verborreia	vɛɹboʁɛja
verbosamente	vɛɾβozɐmẽtɨ
verboso	vɨɾβozu
verdade	vɨɾðaðɨ
verdadeira	vɨɾðɐðɐjɾɐ
verdadeiramente	vɨɾðɐðɐjɾɐmẽtɨ
verdadeiras	vɨɾðɐðɐjɾɐʃ
verdadeiro	vɨɾðɐðɐjɾu
verdadeiros	vɨɾðɐðɐjɾuʃ
verdades	vɨɾðaðɨʃ
verde	veɾðɨ
verdes	veɾðɨʃ
veremos	vɨɾemuʃ
vergel	vɨɾʒɛɫ
vergonha	vɨɾɣoɲɐ
veria	vɨɾiɐ
verme	vɛɾmɨ
vermelha	vɨɾmɐʎɐ
vermelha	vɨɾmɐjʎɐ
vermelho	vɨɾmɐjʎu
vermelho	vɨɾmejʎu
vermelhos	vɨɾmɐjʎuʃ
verniz	vɨɾniʃ
vero	vɛɾu
verso	vɛɾsu
versos	vɛɾsuʃ
vertical	vɨɾtikaɫ
vês	veʃ
vesícula	vizikula
vespa	veʃpɐ
véspera	vɛʃpɨɾɐ
veste	vɛʃtə
vestiário	vɨʃtjaɾju
vestida	vɨʃtiðɐ
vestido	vɨʃtiðu
vestidos	vɨʃtiðuʃ
vestimenta	vɨʃtimẽtɐ
vestir	vɨʃtiɾ
vestuário	vɨʃtwaɾju
vete	vɛtʃi
veto	vɛtu
véu	vɛw
vexame	veʃɐmi
vez	veʃ
vezes	vezɨʃ
vi	vi
via	viɐ
viagem	vjaʒɐ̃j̃
viagem	viaʒẽɪ̯
viagens	viaʒẽʃ
viajado	viɐʒaðu
viajante	vjɐʒɐ̃tɨ
viajar	viɐʒaɾ
viandante	vjɐ̃dɐ̃tɨ
vibrar	viβɾaɾ
viciado	visiadu
viciar	visjaɾ
vício	visju
viço	visu
viçoso	visozu
vida	viðɐ
vidas	viðɐʃ
vide	viðɨ
videira	viðɐjɾɐ
videira	viðejɾɐ
vidigueira	viðiɣɐjɾɐ
vidraça	viðɾasɐ
vidrar	viðɾaɾ
vidraria	viðɾɐɾiɐ
vidreiro	viðɾɐjɾu
vidro	viðɾu
vidros	viðɾuʃ
vieira	vjɐjɾɐ
vieira	vjejɾɐ
viela	viɛlɐ
viela	vjɛlɐ
vier	vjɛɾ
viera	vjɛɾɐ
vieram	vjɛɾɐ̃w̃
viesse	vjɛsɨ
vietname	viɛtnɐmɨ
vietname	vjɛtnɐmɨ
vigente	viʒẽtɨ
vigésimo	viʒɛzimu
vigiar	viʒjaɾ
vigo	viɣu
vigoroso	viɣuɾozu
vil	viɫ
vila	vilɐ
vilancete	vilɐ̃setɨ
vilancico	vilɐ̃siku
vilão	vilɐ̃w̃
vilhancico	viʎɐ̃siku
vim	vĩ
vimioso	vimiozu
vimos	vimuʃ
vinagre	vinaɣɾɨ
vinagrete	vinaɡɾɛtʃi
vincar	vĩkaɾ
vincilho	vĩseʎu
vinda	vĩdɐ
vindimar	vĩdimaɾ
vindo	vĩdu
vindouro	vĩdowɾu
vingança	vĩɡɐ̃sɐ
vingar	vĩɡaɾ
vinha	viɲɐ
vinhais	viɲajʃ
vinho	viɲu
vinhos	viɲuʃ
vínico	viniku
vinte	vĩtɨ
vintém	vĩtɐ̃j̃
vintém	vĩtẽj̃
viola	vjɔlɐ
violação	vjulɐsɐ̃w̃
violão	violãw
violência	vjulẽsjɐ
violentamente	vjulẽtɐmẽtɨ
violento	viulẽtu
violento	vjulẽtu
violeta	vjuletɐ
violino	vjulinu
vir	viɾ
vira	viɾɐ
viram	viɾɐ̃w̃
virar	viɾaɾ
virem	viɾɐ̃j̃
virgem	viɾʒɐ̃j̃
virgindade	viɾʒĩdaðɨ
viria	viɾiɐ
viril	viɾil
virilidade	viɾiliðaðɨ
virou	viɾow
virtual	viɾtuaɫ
virtual	viɾtwaɫ
virtude	viɾtuðɨ
virtuoso	viɾtwozu
visão	vizɐ̃w̃
visar	vizaɾ
viseu	vizew
visita	vizitɐ
visitar	vizitaɾ
visitas	vizitɐʃ
visível	vizivɛɫ
vislumbre	viʒlũbɾɨ
visões	vizõj̃ʃ
visom	vizõ
visse	visɨ
vista	viʃtɐ
viste	viʃtɨ
visto	viʃtu
vistoso	vistozu
vistoso	vijʃtozu
visual	vizwaɫ
vítima	vitimɐ
vitimar	vitimaɾ
vitimismo	vitʃimizmu
vitimismo	vitimiʃmu
vitória	vitɔɾjɐ
vitorioso	vituɾjozu
vitral	vitɾaɫ
viu	viw
viúva	vjuvɐ
viúvo	vjuvu
viva	vivɐ
vivalma	vivaɫmɐ
vivas	vivɐʃ
vivaz	vivaʃ
vive	vivɨ
vivem	vivɐ̃j̃
vivemos	vivemuʃ
vivenda	vivẽdɐ
vivendo	vivẽdu
viver	viveɾ
vivera	viveɾɐ
viverá	vivɨɾa
viveu	vivew
vivia	viviɐ
vivo	vivu
vivos	vivuʃ
vizela	vizɛlɐ
vizinha	viziɲɐ
vizinha	vɨziɲɐ
vizinhança	vɨziɲɐ̃sɐ
vizinhança	viziɲɐ̃sɐ
vizinho	viziɲu
vizinho	vɨziɲu
voador	vwɐðoɾ
voadora	vwɐðoɾɐ
voando	vwɐ̃du
voar	vwaɾ
voara	vwaɾɐ
voará	vwɐɾa
vocabulário	vukɐβulaɾju
vocábulo	vukaβulu
você	vɔse
vocês	vɔseʃ
voçoroca	vosoɾɔka
volante	vulɐ̃tɨ
volta	vɔɫtɐ
voltado	voɫtaðu
voltado	vɔɫtaðu
voltando	voɫtɐ̃du
voltando	vɔɫtɐ̃du
voltar	vɔɫtaɾ
voltara	voɫtaɾɐ
voltará	voɫtɐɾa
voltas	vɔɫtɐʃ
voltasse	vɔɫtasɨ
voltava	voɫtavɐ
voltava	vɔɫtavɐ
voltear	voɫtjaɾ
voltear	vɔɫtjaɾ
volto	vɔɫtu
voltou	vɔɫtow
voluntariamente	vulũtaɾjɐmẽtɨ
voluntário	vulũtaɾiu
voluntário	vulũtaɾju
voluptuário	vuluptwaɾju
voluptuoso	vuluptwozu
volver	voɫveɾ
vomitar	vumitaɾ
vontade	võtaðɨ
vontades	võtaðɨʃ
voo	vou
voragem	vuɾaʒɐ̃j̃
voragem	vuɾaʒẽj̃
vos	vuʃ
vós	vɔʃ
vós	vɔʃ
vossa	vɔsɐ
vosso	vɔsu
vossos	vɔsuʃ
votante	vutɐ̃tɨ
votar	vutaɾ
voto	vɔtu
vou	vow
vouga	vowɣɐ
vouzela	vowzɛlɐ
vovó	vovɔ
voz	vɔʃ
vozear	voziaɾ
vozes	vɔzɨʃ
vulcão	vuɫkɐ̃w̃
vulgar	vuɫɣaɾ
vulgarmente	vuɫɣaɾmẽtɨ
vulgo	vuɫɣu
vulnífico	vuɫnifiku
vulto	vuɫtu
vuvuzela	vuvuzɛla
webnamorada	wɛbinamoɾada
webnamorado	wɛbinamoɾadu
webnamorar	wɛbinamoɾaɾ
webnamorar	wɛbinamoɾaχ
webnamoro	wɛbinamoɾu
wikcionário	wiksjunaɾju
x	ʃiʃ
xá	ʃa
xadrez	ʃɐðɾeʃ
xaile	ʃajlɨ
xamã	ʃɐmɐ̃
xampu	ʃɐ̃pu
xavecar	ʃavekaɾ
xavecar	ʃavekaʁ
xaveco	ʃavɛku
xavier	ʃɐvjɛɾ
xelim	ʃɨlĩ
xeque	ʃɛkɨ
xereca	ʃeɾɛka
xícara	ʃikɐɾɐ
xilindró	ʃilĩdɾɔ
xingar	ʃĩɡaɾ
xis	ʃiʃ
xixi	ʃiʃi
xpto	ʃiʃpeteɔ
xurumbambo	ʃuɾũbɐ̃bu
zagal	zɐɣaɫ
zâmbia	zɐ̃bjɐ
zanga	zɐ̃ɡɐ
zangado	zɐ̃ɡaðu
zangão	zɐ̃ɡɐ̃w̃
zângão	zɐ̃ɡɐ̃w̃
zangar	zɐ̃ɡaɾ
zarpar	zɐɾpaɾ
zás	zaʃ
zé	zɛ
zê	ze
zebra	zeβɾɐ
zebro	zeβɾu
zelador	zɨlɐðoɾ
zepelim	zɨpɨlĩ
zero	zɛɾu
zêzere	zezɨɾɨ
zimbabué	zĩbaβwɛ
zincografia	zĩkoɡɾafia
zona	zonɐ
zoneamento	zonjɐmẽtu
zorra	zoʁɐ
zulu	zulu
zumbi	zũbi
zumbir	zũbiɾ
zurrapa	zuʁapɐ
